Date,Total Pos, Total Long,Total Short,Dollar PnL,Cumulative PnL,Total Market Value,Net Market Value 
19900201,0,0,0,0,0,0,0
19900202,0,0,0,0,0,0,0
19900205,0,0,0,0,0,0,0
19900206,0,0,0,0,0,0,0
19900207,0,0,0,0,0,0,0
19900208,0,0,0,0,0,0,0
19900209,0,0,0,0,0,0,0
19900212,0,0,0,0,0,0,0
19900213,0,0,0,0,0,0,0
19900214,0,0,0,0,0,0,0
19900215,0,0,0,0,0,0,0
19900216,0,0,0,0,0,0,0
19900220,0,0,0,0,0,0,0
19900221,0,0,0,0,0,0,0
19900222,0,0,0,0,0,0,0
19900223,0,0,0,0,0,0,0
19900226,0,0,0,0,0,0,0
19900227,0,0,0,0,0,0,0
19900228,0,0,0,0,0,0,0
19900301,0,0,0,0,0,0,0
19900302,254100,145500,108600,8922,561344,1.02679e+09,1.44582e+06
19900305,283800,173600,110200,-1837,938062,1.15364e+09,2.33657e+06
19900306,303600,208300,95300,73182,8.70145e+06,1.26956e+09,3.78726e+06
19900307,324400,237600,86800,-9473,8.1195e+06,1.35478e+09,5.34417e+06
19900308,335300,262600,72700,82653,1.83713e+07,1.40514e+09,6.38617e+06
19900309,344600,278700,65900,-38781,1.25901e+07,1.42219e+09,7.05531e+06
19900312,355500,299100,56400,33703,1.58417e+07,1.45929e+09,7.92938e+06
19900313,357100,301200,55900,-26920,1.2884e+07,1.45298e+09,7.90161e+06
19900314,365500,310500,55000,18776,1.5509e+07,1.4968e+09,8.10291e+06
19900315,371500,307100,64400,39535,1.96004e+07,1.52743e+09,7.90065e+06
19900316,375800,320800,55000,93658,3.05731e+07,1.55628e+09,8.60639e+06
19900319,379100,322000,57100,50585,3.77143e+07,1.57017e+09,8.78636e+06
19900320,382200,334600,47600,-47430,3.22757e+07,1.57829e+09,9.34064e+06
19900321,391900,337300,54600,-30841,2.86361e+07,1.60247e+09,9.01643e+06
19900322,396300,329000,67300,-112133,1.72403e+07,1.60789e+09,8.31777e+06
19900323,403700,321000,82700,53514,2.31799e+07,1.65981e+09,7.78966e+06
19900326,410400,306600,103800,27522,2.6009e+07,1.69789e+09,6.93392e+06
19900327,411800,295000,116800,75999,3.45035e+07,1.7193e+09,6.13383e+06
19900328,412500,289400,123100,29823,3.40967e+07,1.71855e+09,5.88587e+06
19900329,415700,303600,112100,-38575,2.95892e+07,1.72375e+09,6.56829e+06
19900330,418400,305600,112800,-17817,2.73176e+07,1.73495e+09,6.73706e+06
19900402,420000,310800,109200,-27922,2.34609e+07,1.73318e+09,6.9389e+06
19900403,419700,304200,115500,90475,3.34506e+07,1.75141e+09,7.01937e+06
19900404,420500,280800,139700,-42004,2.88056e+07,1.75237e+09,6.40839e+06
19900405,423300,283900,139400,26658,3.26986e+07,1.76948e+09,6.62504e+06
19900406,424500,263000,161500,22890,3.53275e+07,1.76158e+09,5.72748e+06
19900409,424000,277200,146800,-2280,3.59073e+07,1.76139e+09,5.94531e+06
19900410,425300,273100,152200,-4725,3.4884e+07,1.77723e+09,5.41475e+06
19900411,425800,270800,155000,8392,3.46575e+07,1.78015e+09,5.19822e+06
19900412,428700,258300,170400,18992,3.7081e+07,1.80652e+09,4.59924e+06
19900416,428200,256600,171600,-35197,3.41925e+07,1.79244e+09,4.77907e+06
19900417,427500,269300,158200,3481,3.44706e+07,1.78986e+09,5.23435e+06
19900418,428000,290100,137900,-85297,2.49156e+07,1.7774e+09,6.1297e+06
19900419,427800,285800,142000,-55013,1.75379e+07,1.76476e+09,5.92886e+06
19900420,427400,266800,160600,-15278,1.48638e+07,1.75279e+09,4.5953e+06
19900423,502900,235700,267200,-9992,1.59106e+07,2.19294e+09,1.25961e+06
19900424,517700,199300,318400,5421,1.56171e+07,2.26245e+09,-1.34907e+06
19900425,520000,181000,339000,-5886,1.40956e+07,2.28364e+09,-2.59873e+06
19900426,532700,167000,365700,15595,1.61727e+07,2.34213e+09,-3.91976e+06
19900427,532900,155700,377200,54464,2.42955e+07,2.31832e+09,-4.59959e+06
19900430,538200,157200,381000,-9337,2.07202e+07,2.33137e+09,-5.27472e+06
19900501,537400,165800,371600,-1622,2.00554e+07,2.32752e+09,-4.54883e+06
19900502,536600,178100,358500,13586,1.73874e+07,2.31269e+09,-3.84175e+06
19900503,535900,196100,339800,-24734,1.45363e+07,2.3181e+09,-2.77292e+06
19900504,535100,243800,291300,18229,1.75476e+07,2.33392e+09,220598
19900507,536300,293400,242900,37615,2.33192e+07,2.35954e+09,3.05845e+06
19900508,535200,337500,197700,28881,2.73655e+07,2.35786e+09,5.38376e+06
19900509,536200,389700,146500,6547,2.84781e+07,2.35903e+09,7.98298e+06
19900510,533700,419400,114300,31523,3.15123e+07,2.35866e+09,9.42892e+06
19900511,530700,436100,94600,190949,5.56299e+07,2.38356e+09,1.07688e+07
19900514,530300,447600,82700,62426,6.18167e+07,2.3927e+09,1.15385e+07
19900515,529400,473500,55900,25330,6.55965e+07,2.39457e+09,1.28389e+07
19900516,529400,485900,43500,8175,6.60638e+07,2.39561e+09,1.31909e+07
19900517,528800,500000,28800,49577,7.14966e+07,2.40618e+09,1.41778e+07
19900518,528800,505200,23600,41327,7.68645e+07,2.41086e+09,1.4344e+07
19900521,528000,504400,23600,147530,9.71551e+07,2.42678e+09,1.44833e+07
19900522,528200,505000,23200,13755,9.8028e+07,2.43304e+09,1.44888e+07
19900523,527400,516900,10500,60961,1.05615e+08,2.43857e+09,1.47647e+07
19900524,527500,515100,12400,514,1.04921e+08,2.44068e+09,1.465e+07
19900525,527600,512800,14800,-142859,8.41087e+07,2.42045e+09,1.42735e+07
19900529,527800,506300,21500,180781,1.04995e+08,2.45177e+09,1.40963e+07
19900530,528600,482200,46400,20182,1.07067e+08,2.46337e+09,1.32763e+07
19900531,529000,467500,61500,-24045,1.0197e+08,2.46431e+09,1.24006e+07
19900601,529000,463400,65600,7101,9.91138e+07,2.47217e+09,1.22887e+07
19900604,528500,463300,65200,125742,1.13656e+08,2.49294e+09,1.24106e+07
19900605,528100,467200,60900,-23814,1.1054e+08,2.4887e+09,1.24983e+07
19900606,527900,487900,40000,-45024,1.04919e+08,2.48e+09,1.31988e+07
19900607,527200,479300,47900,-57848,9.7919e+07,2.46248e+09,1.25425e+07
19900608,527300,471700,55600,-120942,8.43662e+07,2.43471e+09,1.19455e+07
19900611,525600,454800,70800,26718,8.38698e+07,2.43577e+09,1.12337e+07
19900612,527300,423400,103900,106417,9.61745e+07,2.47601e+09,1.04979e+07
19900613,526800,408100,118700,13892,9.75997e+07,2.47656e+09,9.89862e+06
19900614,526600,411200,115400,-16806,9.60678e+07,2.46924e+09,9.62986e+06
19900615,525200,413600,111600,-7609,9.66996e+07,2.45698e+09,9.72264e+06
19900618,523400,396600,126800,-113129,8.12253e+07,2.41372e+09,8.83854e+06
19900619,522800,375700,147100,23066,8.37384e+07,2.42006e+09,7.88676e+06
19900620,523100,360400,162700,-34550,7.87289e+07,2.42065e+09,6.79733e+06
19900621,523400,339900,183500,57526,8.60785e+07,2.42681e+09,5.78548e+06
19900622,523100,334100,189000,-21182,8.50589e+07,2.40622e+09,5.15297e+06
19900625,524100,318100,206000,-1992,8.45851e+07,2.39228e+09,4.32868e+06
19900626,524100,310200,213900,-405,8.44131e+07,2.38981e+09,3.59845e+06
19900627,524200,274300,249900,25080,8.91937e+07,2.40647e+09,1.91363e+06
19900628,524600,268200,256400,22291,9.24864e+07,2.42665e+09,1.00146e+06
19900629,522300,278900,243400,-11667,9.10088e+07,2.42127e+09,1.32117e+06
19900702,521100,301400,219700,33193,9.51326e+07,2.42331e+09,2.80796e+06
19900703,520100,334300,185800,36824,1.00145e+08,2.4223e+09,4.78026e+06
19900705,518900,340100,178800,-36085,9.47175e+07,2.39395e+09,4.82963e+06
19900706,518100,332900,185200,60069,1.02001e+08,2.40557e+09,4.85809e+06
19900709,517000,330600,186400,-33177,1.06376e+08,2.38868e+09,4.8174e+06
19900710,516600,328300,188300,-21863,1.04824e+08,2.37631e+09,4.66978e+06
19900711,515400,343400,172000,83576,1.15345e+08,2.39537e+09,5.48178e+06
19900712,518200,345200,173000,120971,1.31659e+08,2.44317e+09,6.04342e+06
19900713,517200,358400,158800,5625,1.33117e+08,2.44356e+09,6.88047e+06
19900716,520000,378000,142000,-8479,1.31107e+08,2.45827e+09,8.24241e+06
19900717,519100,394900,124200,-40924,1.25997e+08,2.44463e+09,9.50111e+06
19900718,519400,391400,128000,-69825,1.16252e+08,2.42302e+09,9.734e+06
19900719,519000,395000,124000,-16162,1.15377e+08,2.41619e+09,9.81132e+06
19900720,520200,388300,131900,-42226,1.09412e+08,2.40539e+09,9.41225e+06
19900723,522700,354300,168400,-126781,9.39554e+07,2.37546e+09,7.71864e+06
19900724,525900,309400,216500,30801,9.83721e+07,2.38484e+09,4.90048e+06
19900725,527900,274000,253900,12767,9.95629e+07,2.40662e+09,2.22292e+06
19900726,529500,241900,287600,17253,1.02256e+08,2.40878e+09,113157
19900727,530100,221600,308500,53903,1.06268e+08,2.39701e+09,-1.16537e+06
19900730,530800,222200,308600,40420,1.11379e+08,2.40469e+09,-1.36884e+06
19900731,530700,235500,295200,64159,1.19539e+08,2.40457e+09,-478184
19900801,530400,235700,294700,47682,1.2477e+08,2.39822e+09,-546396
19900802,531400,229100,302300,95286,1.38827e+08,2.37906e+09,-785348
19900803,534000,176500,357500,147278,1.60841e+08,2.33797e+09,-3.32124e+06
19900806,535400,139400,396000,295725,2.00076e+08,2.25685e+09,-4.85338e+06
19900807,537500,123000,414500,-25801,1.96428e+08,2.26012e+09,-6.06245e+06
19900808,537400,110500,426900,-150706,1.76553e+08,2.2823e+09,-7.1573e+06
19900809,537600,105700,431900,-85043,1.65991e+08,2.29499e+09,-7.72379e+06
19900810,537800,102900,434900,147450,1.84674e+08,2.26885e+09,-7.93509e+06
19900813,538000,108200,429800,-55641,1.76599e+08,2.2845e+09,-7.75491e+06
19900814,538700,112000,426700,-14859,1.74568e+08,2.29198e+09,-7.62343e+06
19900815,538400,124500,413900,-44836,1.68785e+08,2.30257e+09,-7.04762e+06
19900816,538600,127600,411000,189279,1.92376e+08,2.25582e+09,-6.59394e+06
19900817,538900,131400,407500,203512,2.17873e+08,2.21483e+09,-6.40637e+06
19900820,539300,132000,407300,28827,2.20688e+08,2.21445e+09,-6.51443e+06
19900821,540500,125100,415400,172366,2.41064e+08,2.17192e+09,-6.69103e+06
19900822,543300,93700,449600,125763,2.55777e+08,2.15718e+09,-8.08683e+06
19900823,546200,64300,481900,330078,2.95606e+08,2.1031e+09,-9.21726e+06
19900824,548700,35200,513500,-201232,2.67797e+08,2.14458e+09,-1.09386e+07
19900827,548900,27100,521800,-414245,2.16665e+08,2.21142e+09,-1.1828e+07
19900828,548400,44100,504300,-43774,2.13879e+08,2.21748e+09,-1.15423e+07
19900829,550100,53100,497000,-71584,2.05816e+08,2.2478e+09,-1.10527e+07
19900830,551400,91200,460200,103633,2.19033e+08,2.22128e+09,-9.12989e+06
19900831,557800,179900,377900,-14517,2.15845e+08,2.26219e+09,-4.88454e+06
19900904,559500,210200,349300,25083,2.1778e+08,2.27236e+09,-3.61318e+06
19900905,561000,230100,330900,-84053,2.09272e+08,2.26665e+09,-2.43109e+06
19900906,562800,258400,304400,-31354,2.03126e+08,2.24129e+09,-753833
19900907,565400,306800,258600,51719,2.09647e+08,2.26798e+09,1.82055e+06
19900910,569200,314800,254400,17960,2.10548e+08,2.29304e+09,2.3975e+06
19900911,568900,332400,236500,11505,2.11176e+08,2.28819e+09,3.51682e+06
19900912,569700,346900,222800,40614,2.14732e+08,2.29903e+09,4.09521e+06
19900913,571100,379500,191600,-67493,2.06716e+08,2.27749e+09,5.6515e+06
19900914,573600,376400,197200,-4047,2.06375e+08,2.27727e+09,5.33263e+06
19900917,577400,365300,212100,29457,2.09191e+08,2.29327e+09,4.63262e+06
19900918,579200,354100,225100,17529,2.11473e+08,2.30172e+09,3.8462e+06
19900919,581900,344000,237900,11039,2.13201e+08,2.30074e+09,3.23868e+06
19900920,588000,316400,271600,-4159,2.12823e+08,2.28426e+09,2.15334e+06
19900921,590500,295800,294700,41455,2.18459e+08,2.27797e+09,1.00754e+06
19900924,593700,250400,343300,88806,2.32365e+08,2.24487e+09,-566047
19900925,598100,210200,387900,-61944,2.22698e+08,2.28279e+09,-2.68248e+06
19900926,600300,191400,408900,100254,2.3371e+08,2.2659e+09,-3.80265e+06
19900927,607100,150100,457000,169264,2.56402e+08,2.26138e+09,-5.42223e+06
19900928,611200,131500,479700,-124675,2.4326e+08,2.30855e+09,-6.4504e+06
19901001,611900,144900,467000,-242775,2.05336e+08,2.36303e+09,-5.72416e+06
19901002,612200,164600,447600,-6466,2.05765e+08,2.37733e+09,-4.46788e+06
19901003,612800,183000,429800,65050,2.14787e+08,2.35535e+09,-3.09338e+06
19901004,611100,213800,397300,66273,2.24479e+08,2.35557e+09,-1.18198e+06
19901005,613500,251500,362000,23907,2.29149e+08,2.34758e+09,-97456
19901008,614500,268700,345800,35565,2.32799e+08,2.34849e+09,582994
19901009,618000,265500,352500,38127,2.36366e+08,2.29713e+09,484393
19901010,620300,263000,357300,19254,2.40608e+08,2.27351e+09,418764
19901011,627000,230500,396500,76562,2.47002e+08,2.2488e+09,-910495
19901012,628100,199000,429100,-17781,2.45287e+08,2.27865e+09,-1.91503e+06
19901015,630100,176600,453500,2239,2.44911e+08,2.29933e+09,-3.11943e+06
19901016,630900,182200,448700,90506,2.51921e+08,2.27499e+09,-3.26768e+06
19901017,631500,181100,450400,-6801,2.4984e+08,2.27778e+09,-3.50451e+06
19901018,637100,211000,426100,-104716,2.40656e+08,2.36735e+09,-2.18848e+06
19901019,639400,259300,380100,-291,2.42313e+08,2.41466e+09,-529667
19901022,639000,301800,337200,-4441,2.45823e+08,2.44153e+09,1.37672e+06
19901023,646400,371900,274500,-81259,2.34466e+08,2.44455e+09,4.43452e+06
19901024,651800,418400,233400,-26327,2.34056e+08,2.44181e+09,5.92489e+06
19901025,655400,446000,209400,-85399,2.2232e+08,2.42818e+09,6.63636e+06
19901026,660000,424000,236000,-130131,2.03631e+08,2.41015e+09,6.03924e+06
19901029,663600,425400,238200,-57972,1.94124e+08,2.3954e+09,5.44731e+06
19901030,670700,425000,245700,43925,2.00922e+08,2.42987e+09,4.83951e+06
19901031,679600,387200,292400,47005,2.08143e+08,2.442e+09,3.7441e+06
19901101,683700,355500,328200,-2131,2.08124e+08,2.46624e+09,3.02866e+06
19901102,682600,367400,315200,12283,2.12097e+08,2.51478e+09,3.37428e+06
19901105,677600,433200,244400,43455,2.19124e+08,2.52273e+09,5.71187e+06
19901106,677800,464600,213200,-43368,2.13882e+08,2.50794e+09,7.00084e+06
19901107,682100,489000,193100,-118829,1.98303e+08,2.49427e+09,8.2673e+06
19901108,684900,490000,194900,46777,2.02144e+08,2.49256e+09,8.7324e+06
19901109,688800,494600,194200,167370,2.23535e+08,2.54643e+09,9.063e+06
19901112,688000,516800,171200,185377,2.47203e+08,2.59869e+09,9.80334e+06
19901113,687800,506300,181500,45748,2.49596e+08,2.60733e+09,9.49875e+06
19901114,690400,550900,139500,124325,2.63022e+08,2.65702e+09,1.06136e+07
19901115,687200,581900,105300,-65296,2.54918e+08,2.64312e+09,1.15753e+07
19901116,685700,607100,78600,14264,2.56051e+08,2.64138e+09,1.27506e+07
19901119,686200,610600,75600,106617,2.6971e+08,2.66065e+09,1.25071e+07
19901120,686200,609000,77200,-149239,2.51411e+08,2.63211e+09,1.1989e+07
19901121,686200,600900,85300,-1984,2.51332e+08,2.63575e+09,1.1629e+07
19901123,686800,598200,88600,-30123,2.475e+08,2.63479e+09,1.14996e+07
19901126,688200,591100,97100,27083,2.52286e+08,2.64951e+09,1.15262e+07
19901127,688200,591300,96900,147884,2.69537e+08,2.68149e+09,1.15488e+07
19901128,687800,575800,112000,21543,2.69851e+08,2.68572e+09,1.15743e+07
19901129,688000,571800,116200,-38218,2.65184e+08,2.67718e+09,1.15531e+07
19901130,686700,576800,109900,194118,2.88959e+08,2.7092e+09,1.22228e+07
19901203,684700,582300,102400,145088,3.02743e+08,2.73262e+09,1.26859e+07
19901204,682000,597300,84700,126883,3.15079e+08,2.74824e+09,1.3247e+07
19901205,676200,594300,81900,218340,3.38718e+08,2.76726e+09,1.36343e+07
19901206,674900,605700,69200,-22261,3.34713e+08,2.75275e+09,1.39313e+07
19901207,674600,605800,68800,-60783,3.28379e+08,2.73973e+09,1.40292e+07
19901210,674100,601000,73100,41563,3.35826e+08,2.74055e+09,1.38174e+07
19901211,672600,595100,77500,-81231,3.26377e+08,2.71441e+09,1.34884e+07
19901212,670200,560800,109400,138962,3.43546e+08,2.73681e+09,1.3012e+07
19901213,666500,530000,136500,22787,3.4712e+08,2.71305e+09,1.24002e+07
19901214,665700,521300,144400,-115603,3.33953e+08,2.68516e+09,1.17639e+07
19901217,666300,510200,156100,-39451,3.27421e+08,2.67573e+09,1.13613e+07
19901218,665600,507700,157900,131795,3.45852e+08,2.70255e+09,1.15823e+07
19901219,666800,492200,174600,60562,3.53887e+08,2.71408e+09,1.10403e+07
19901220,666200,508500,157700,27794,3.5938e+08,2.71501e+09,1.14296e+07
19901221,665500,512200,153300,91708,3.70188e+08,2.72135e+09,1.1645e+07
19901224,664500,529100,135400,-57440,3.63294e+08,2.70519e+09,1.16055e+07
19901226,663500,515400,148100,-26508,3.61345e+08,2.7011e+09,1.09367e+07
19901227,662800,508400,154400,-76335,3.51642e+08,2.68654e+09,1.02416e+07
19901228,661800,467500,194300,9374,3.52501e+08,2.69317e+09,8.91459e+06
19901231,662500,464100,198400,36060,3.58688e+08,2.70861e+09,9.08502e+06
19910102,658400,471800,186600,-87180,3.48558e+08,2.66309e+09,8.57083e+06
19910103,658900,452800,206100,-99218,3.37284e+08,2.6343e+09,7.62163e+06
19910104,657200,423100,234100,-4504,3.36085e+08,2.62247e+09,6.01141e+06
19910107,656700,378100,278600,-6014,3.34907e+08,2.5796e+09,3.4287e+06
19910108,655700,335100,320600,-5379,3.34912e+08,2.56774e+09,231322
19910109,654300,270200,384100,77438,3.42672e+08,2.53858e+09,-3.27422e+06
19910110,654800,244000,410800,-29108,3.40865e+08,2.55719e+09,-4.50242e+06
19910111,651700,236200,415500,12977,3.41222e+08,2.54594e+09,-4.77579e+06
19910114,650000,236000,414000,12913,3.41685e+08,2.51339e+09,-4.79521e+06
19910115,646200,210800,435400,-46397,3.3625e+08,2.50474e+09,-5.98682e+06
19910116,645300,213200,432100,-59324,3.28415e+08,2.54185e+09,-5.67941e+06
19910117,642700,251700,391000,-136601,3.1363e+08,2.60942e+09,-3.48996e+06
19910118,638900,331600,307300,65912,3.22387e+08,2.62693e+09,927320
19910121,633200,415600,217600,37239,3.29516e+08,2.60673e+09,5.80924e+06
19910122,623700,458200,165500,-59873,3.248e+08,2.54846e+09,8.39496e+06
19910123,619600,488200,131400,58800,3.29442e+08,2.55801e+09,9.58598e+06
19910124,617100,515900,101200,200799,3.51347e+08,2.59194e+09,1.08383e+07
19910125,615600,526000,89600,35709,3.55774e+08,2.59197e+09,1.13478e+07
19910128,615200,558900,56300,43779,3.61171e+08,2.58505e+09,1.20399e+07
19910129,614900,567900,47000,51149,3.65494e+08,2.5924e+09,1.25429e+07
19910130,613500,578900,34600,264378,3.98701e+08,2.62733e+09,1.33812e+07
19910131,612600,577400,35200,139799,4.1379e+08,2.65479e+09,1.33781e+07
19910201,612400,583800,28600,67526,4.24278e+08,2.65621e+09,1.3794e+07
19910204,612500,591400,21100,309222,4.61281e+08,2.69982e+09,1.43614e+07
19910205,611800,591700,20100,169567,4.79566e+08,2.72565e+09,1.46459e+07
19910206,611400,598500,12900,238737,5.08378e+08,2.76642e+09,1.5335e+07
19910207,610800,597900,12900,-87864,4.98066e+08,2.75468e+09,1.52253e+07
19910208,610600,605700,4900,85196,5.11167e+08,2.76989e+09,1.57861e+07
19910211,610400,605400,5000,410874,5.61729e+08,2.83618e+09,1.61744e+07
19910212,610500,604700,5800,-39339,5.5636e+08,2.83044e+09,1.61264e+07
19910213,612300,591700,20600,118357,5.72201e+08,2.84782e+09,1.6149e+07
19910214,610200,589600,20600,-197298,5.46826e+08,2.80768e+09,1.59287e+07
19910215,610200,592700,17500,185743,5.72158e+08,2.83756e+09,1.62361e+07
19910219,609200,588400,20800,-19358,5.6871e+08,2.83598e+09,1.6075e+07
19910220,609400,584500,24900,-177899,5.46999e+08,2.80783e+09,1.55374e+07
19910221,609400,580900,28500,-35019,5.41392e+08,2.80209e+09,1.52556e+07
19910222,608800,566400,42400,53016,5.49254e+08,2.80715e+09,1.4932e+07
19910225,608400,541400,67000,40630,5.55667e+08,2.81773e+09,1.36338e+07
19910226,608500,531300,77200,-123846,5.40785e+08,2.78963e+09,1.30212e+07
19910227,597600,480700,116900,106639,5.54392e+08,2.77447e+09,1.21002e+07
19910228,595400,474100,121300,25562,5.55564e+08,2.76495e+09,1.17426e+07
19910301,592000,470100,121900,90741,5.66211e+08,2.77252e+09,1.17784e+07
19910304,591000,466100,124900,40595,5.72362e+08,2.76962e+09,1.1434e+07
19910305,584600,472800,111800,268821,6.05752e+08,2.79041e+09,1.2421e+07
19910306,577200,475300,101900,-5264,6.0684e+08,2.76236e+09,1.25185e+07
19910307,569500,484800,84700,36369,6.14138e+08,2.72411e+09,1.27389e+07
19910308,566400,480400,86000,-13453,6.11492e+08,2.70681e+09,1.25288e+07
19910311,565000,472000,93000,-106966,5.9573e+08,2.68061e+09,1.21505e+07
19910312,564600,468200,96400,-138581,5.79246e+08,2.65476e+09,1.1754e+07
19910313,564300,474200,90100,91975,5.89885e+08,2.67906e+09,1.17447e+07
19910314,562300,464100,98200,6699,5.91088e+08,2.66805e+09,1.14691e+07
19910315,559000,437900,121100,-47638,5.86329e+08,2.63679e+09,1.05212e+07
19910318,555700,434700,121000,-22685,5.86841e+08,2.61089e+09,1.00246e+07
19910319,555100,419500,135600,-74610,5.7847e+08,2.58799e+09,9.17986e+06
19910320,552900,429000,123900,40099,5.80935e+08,2.59296e+09,8.18679e+06
19910321,548900,407900,141000,9001,5.80986e+08,2.56104e+09,6.81056e+06
19910322,546400,381600,164800,54127,5.8636e+08,2.54889e+09,5.71445e+06
19910325,542100,358900,183200,38919,5.9143e+08,2.5612e+09,4.9551e+06
19910326,539800,357900,181900,79616,6.0255e+08,2.59575e+09,4.85042e+06
19910327,536700,363900,172800,7317,6.03644e+08,2.59407e+09,5.47943e+06
19910328,533600,385200,148400,13741,6.05035e+08,2.57288e+09,7.2245e+06
19910401,528800,396500,132300,-158307,5.92698e+08,2.50568e+09,7.7252e+06
19910402,521700,407400,114300,188503,6.15e+08,2.5046e+09,8.6717e+06
19910403,518000,416600,101400,27652,6.17233e+08,2.49273e+09,9.24205e+06
19910404,516500,435000,81500,40544,6.22639e+08,2.49305e+09,1.0237e+07
19910405,515800,434100,81700,-108580,6.07763e+08,2.46953e+09,1.02592e+07
19910408,512800,442900,69900,51757,6.13608e+08,2.4755e+09,1.10354e+07
19910409,511900,444900,67000,-136547,5.95865e+08,2.44504e+09,1.09015e+07
19910410,511600,441300,70300,-37390,5.9216e+08,2.43727e+09,1.05028e+07
19910411,510300,415700,94600,193396,6.14867e+08,2.46619e+09,9.81436e+06
19910412,511300,415200,96100,65357,6.21887e+08,2.49199e+09,1.01472e+07
19910415,509600,411300,98300,15612,6.22052e+08,2.48336e+09,1.00131e+07
19910416,509100,423100,86000,109320,6.37199e+08,2.50491e+09,1.10558e+07
19910417,506100,440400,65700,174787,6.57988e+08,2.52291e+09,1.21432e+07
19910418,505400,450000,55400,-49417,6.542e+08,2.50912e+09,1.29329e+07
19910419,505100,445100,60000,-156811,6.34871e+08,2.47835e+09,1.26278e+07
19910422,504200,443000,61200,-146318,6.14842e+08,2.45241e+09,1.23225e+07
19910423,504100,450900,53200,29308,6.18994e+08,2.45868e+09,1.19725e+07
19910424,503300,435500,67800,24255,6.20483e+08,2.45911e+09,1.06321e+07
19910425,504000,405900,98100,-60515,6.11751e+08,2.44766e+09,9.126e+06
19910426,503400,380000,123400,-43448,6.06756e+08,2.44254e+09,7.81808e+06
19910429,510000,362600,147400,-31130,6.03808e+08,2.44654e+09,6.31691e+06
19910430,509800,329400,180400,39047,6.09466e+08,2.45037e+09,4.18048e+06
19910501,509400,307500,201900,-6314,6.05315e+08,2.47298e+09,2.86138e+06
19910502,508700,312100,196600,815,6.06712e+08,2.48102e+09,3.06862e+06
19910503,509400,295800,213600,18485,6.10254e+08,2.48558e+09,3.08728e+06
19910506,509400,299400,210000,-35095,6.05648e+08,2.48656e+09,3.67384e+06
19910507,509000,309300,199700,-22460,6.04396e+08,2.47038e+09,4.27402e+06
19910508,508600,325900,182700,35874,6.08862e+08,2.46962e+09,4.96958e+06
19910509,506900,332700,174200,46126,6.15525e+08,2.49813e+09,5.24851e+06
19910510,506100,334100,172000,-61035,6.06899e+08,2.46558e+09,5.15462e+06
19910513,506400,344200,162200,4590,6.07591e+08,2.46715e+09,5.41954e+06
19910514,506800,323800,183000,-29100,6.03995e+08,2.44671e+09,4.28954e+06
19910515,509500,293000,216500,-106,6.02168e+08,2.42517e+09,3.36638e+06
19910516,510200,267000,243200,8506,6.0427e+08,2.44138e+09,2.08423e+06
19910517,510700,262000,248700,16658,6.07015e+08,2.44912e+09,1.63557e+06
19910520,510600,255600,255000,27132,6.10568e+08,2.44456e+09,1.30606e+06
19910521,510300,252500,257800,-4198,6.09961e+08,2.46159e+09,1.53542e+06
19910522,513200,273000,240200,-37979,6.03071e+08,2.49303e+09,2.7439e+06
19910523,513300,284900,228400,-10445,6.03466e+08,2.49105e+09,3.31452e+06
19910524,512700,296800,215900,23189,6.05091e+08,2.50377e+09,4.48381e+06
19910528,511200,326900,184300,49658,6.11653e+08,2.51914e+09,6.16396e+06
19910529,511600,351600,160000,-17427,6.08836e+08,2.52515e+09,7.41272e+06
19910530,509100,362500,146600,126178,6.24069e+08,2.54318e+09,8.56108e+06
19910531,505100,405600,99500,93705,6.35579e+08,2.54819e+09,1.10156e+07
19910603,503300,437700,65600,-70219,6.31478e+08,2.48744e+09,1.22464e+07
19910604,503700,447400,56300,12741,6.33576e+08,2.48612e+09,1.26503e+07
19910605,503300,453500,49800,-49375,6.28559e+08,2.47242e+09,1.2795e+07
19910606,505100,431800,73300,-2060,6.289e+08,2.46973e+09,1.25472e+07
19910607,505700,416700,89000,-103798,6.17543e+08,2.45121e+09,1.14886e+07
19910610,506300,404200,102100,-94827,6.05242e+08,2.43442e+09,1.05526e+07
19910611,507100,401100,106000,37452,6.10276e+08,2.44823e+09,1.01419e+07
19910612,508700,386700,122000,-84691,5.99488e+08,2.42995e+09,8.88727e+06
19910613,510100,360300,149800,29000,6.05363e+08,2.44471e+09,7.05198e+06
19910614,509800,348800,161000,30848,6.12465e+08,2.45639e+09,6.46395e+06
19910617,510700,335600,175100,13225,6.15242e+08,2.45788e+09,5.92003e+06
19910618,511100,327800,183300,-4614,6.16084e+08,2.45116e+09,5.20943e+06
19910619,512200,332500,179700,-32914,6.1347e+08,2.43343e+09,5.07424e+06
19910620,512000,321600,190400,-34049,6.08462e+08,2.42818e+09,4.53118e+06
19910621,512100,312500,199600,1677,6.08195e+08,2.43929e+09,3.9397e+06
19910624,516000,270400,245600,5991,6.0923e+08,2.41713e+09,1.21491e+06
19910625,516900,249000,267900,606,6.07896e+08,2.41743e+09,-215994
19910626,518000,208100,309900,9571,6.10185e+08,2.4231e+09,-1.8807e+06
19910627,518300,190900,327400,30313,6.13422e+08,2.42414e+09,-2.56445e+06
19910628,518000,177500,340500,23201,6.16611e+08,2.40949e+09,-3.65523e+06
19910701,517800,192100,325700,-39561,6.13196e+08,2.44914e+09,-2.60016e+06
19910702,518000,205900,312100,34168,6.19305e+08,2.44615e+09,-1.22768e+06
19910703,517400,225700,291700,10971,6.19753e+08,2.41966e+09,257504
19910705,517500,242400,275100,14274,6.2213e+08,2.42118e+09,1.6032e+06
19910708,516000,256700,259300,14132,6.2492e+08,2.43441e+09,2.81825e+06
19910709,515900,268200,247700,-19908,6.22515e+08,2.43579e+09,3.90814e+06
19910710,515200,274500,240700,3717,6.23217e+08,2.43556e+09,4.119e+06
19910711,512800,294100,218700,33107,6.25505e+08,2.43716e+09,5.03805e+06
19910712,512200,329500,182700,44599,6.31093e+08,2.45392e+09,6.34948e+06
19910715,507900,360300,147600,47070,6.35323e+08,2.43342e+09,7.37701e+06
19910716,506400,387500,118900,-15444,6.31219e+08,2.42276e+09,8.972e+06
19910717,509300,398400,110900,49080,6.37053e+08,2.43386e+09,1.00917e+07
19910718,508300,411200,97100,87853,6.46628e+08,2.45078e+09,1.08132e+07
19910719,507200,415800,91400,-1154,6.47558e+08,2.44139e+09,1.11277e+07
19910722,506700,419100,87600,-78640,6.39012e+08,2.42502e+09,1.12722e+07
19910723,509000,400900,108100,-97883,6.26036e+08,2.4129e+09,9.99328e+06
19910724,512700,393500,119200,-9711,6.27084e+08,2.43221e+09,9.58447e+06
19910725,514300,380800,133500,44877,6.32394e+08,2.45455e+09,9.15279e+06
19910726,514400,372800,141600,15101,6.33963e+08,2.45894e+09,8.59059e+06
19910729,514100,364500,149600,63960,6.4402e+08,2.46186e+09,8.2712e+06
19910730,512600,355800,156800,71556,6.51287e+08,2.4775e+09,7.96444e+06
19910731,512600,382000,130600,18013,6.5332e+08,2.48481e+09,8.48318e+06
19910801,512500,394100,118400,-40267,6.4904e+08,2.47831e+09,8.83786e+06
19910802,510600,395000,115600,32392,6.52443e+08,2.47416e+09,8.86371e+06
19910805,509200,399200,110000,-12562,6.48617e+08,2.45584e+09,9.17084e+06
19910806,508700,398300,110400,124221,6.65418e+08,2.48212e+09,9.26866e+06
19910807,506700,404000,102700,17464,6.67514e+08,2.47987e+09,9.55686e+06
19910808,505700,404400,101300,-264,6.68855e+08,2.47529e+09,9.66252e+06
19910809,505600,394400,111200,-14314,6.6616e+08,2.47088e+09,9.26892e+06
19910812,505600,404900,100700,31006,6.68038e+08,2.47834e+09,9.64897e+06
19910813,506300,400000,106300,29399,6.73505e+08,2.4912e+09,9.22197e+06
19910814,506700,412700,94000,44010,6.79946e+08,2.49753e+09,9.37015e+06
19910815,512600,418800,93800,-7549,6.77313e+08,2.51874e+09,9.09951e+06
19910816,512400,414400,98000,-55963,6.69835e+08,2.49517e+09,8.92931e+06
19910819,513200,401200,112000,-170838,6.45785e+08,2.43958e+09,7.80784e+06
19910820,514800,375600,139200,61593,6.53943e+08,2.46458e+09,6.2149e+06
19910821,522000,362300,159700,146967,6.72466e+08,2.54264e+09,5.72461e+06
19910822,521700,343100,178600,30256,6.77248e+08,2.554e+09,5.13223e+06
19910823,520800,352100,168700,-13284,6.76508e+08,2.56612e+09,5.71816e+06
19910826,519600,390700,128900,-14191,6.75599e+08,2.5612e+09,8.39506e+06
19910827,517200,421200,96000,17160,6.80198e+08,2.54644e+09,1.07273e+07
19910828,515400,436600,78800,76509,6.91775e+08,2.55392e+09,1.13579e+07
19910829,514400,452100,62300,19401,6.93515e+08,2.55263e+09,1.22139e+07
19910830,513400,450300,63100,-72369,6.85989e+08,2.5257e+09,1.2047e+07
19910903,515300,433100,82200,-71721,6.76435e+08,2.50621e+09,1.17319e+07
19910904,515500,439700,75800,-60134,6.69552e+08,2.4925e+09,1.21281e+07
19910905,515800,439900,75900,-9309,6.69153e+08,2.48815e+09,1.17461e+07
19910906,516200,426000,90200,-14437,6.66922e+08,2.48755e+09,1.06602e+07
19910909,516600,404400,112200,5334,6.67806e+08,2.48974e+09,9.11991e+06
19910910,515800,352700,163100,-57167,6.61304e+08,2.45916e+09,6.74119e+06
19910911,515600,335000,180600,-29504,6.52082e+08,2.45571e+09,5.37312e+06
19910912,515900,325800,190100,29091,6.55973e+08,2.47784e+09,4.81605e+06
19910913,516100,303700,212400,-32485,6.52052e+08,2.45725e+09,3.57687e+06
19910916,516900,285500,231400,32337,6.55735e+08,2.4719e+09,2.53674e+06
19910917,516900,270900,246000,21291,6.57876e+08,2.47045e+09,2.09965e+06
19910918,517100,262600,254500,12914,6.58245e+08,2.48772e+09,1.51052e+06
19910919,515600,268700,246900,10995,6.57606e+08,2.49447e+09,1.86425e+06
19910920,515600,276900,238700,57260,6.64258e+08,2.50241e+09,2.53087e+06
19910923,514900,301000,213900,5744,6.65246e+08,2.49456e+09,3.83132e+06
19910924,513800,308500,205300,17184,6.65986e+08,2.50297e+09,4.57743e+06
19910925,509600,316400,193200,47596,6.70263e+08,2.48837e+09,5.42246e+06
19910926,508200,319400,188800,33956,6.73275e+08,2.47959e+09,5.54498e+06
19910927,508400,317800,190600,23724,6.75761e+08,2.47633e+09,5.44826e+06
19910930,506800,324000,182800,60234,6.83619e+08,2.47836e+09,6.0457e+06
19911001,506300,347400,158900,19787,6.86067e+08,2.47455e+09,7.1137e+06
19911002,506600,352500,154100,-88365,6.75226e+08,2.45122e+09,7.85864e+06
19911003,507600,342100,165500,-38942,6.71375e+08,2.43619e+09,7.347e+06
19911004,508700,338800,169900,8338,6.71849e+08,2.43705e+09,6.91764e+06
19911007,509400,332200,177200,-67935,6.65645e+08,2.42651e+09,6.38407e+06
19911008,510200,329500,180700,-1066,6.65801e+08,2.43981e+09,4.96397e+06
19911009,510500,310900,199600,20111,6.65173e+08,2.41975e+09,3.42924e+06
19911010,511700,308800,202900,35075,6.67949e+08,2.42654e+09,3.35094e+06
19911011,511400,309200,202200,-3203,6.67919e+08,2.43061e+09,3.35112e+06
19911014,514600,314500,200100,31065,6.72712e+08,2.4913e+09,3.80918e+06
19911015,514100,329700,184400,38039,6.76296e+08,2.51785e+09,4.91913e+06
19911016,512100,392000,120100,112762,6.90441e+08,2.52552e+09,8.53633e+06
19911017,509700,413400,96300,-21584,6.8672e+08,2.50907e+09,9.9993e+06
19911018,507200,427700,79500,77870,6.97327e+08,2.51236e+09,1.13333e+07
19911021,506200,429600,76600,-31878,6.94157e+08,2.49636e+09,1.14833e+07
19911022,506300,427300,79000,-12576,6.94248e+08,2.4873e+09,1.13407e+07
19911023,506400,424600,81800,17017,6.95625e+08,2.49126e+09,1.12172e+07
19911024,505500,417600,87900,-68569,6.85619e+08,2.4646e+09,1.03707e+07
19911025,509900,427300,82600,-46440,6.78256e+08,2.46957e+09,9.90478e+06
19911028,514200,409700,104500,71941,6.90756e+08,2.48293e+09,9.86182e+06
19911029,513700,415300,98400,77055,7.0342e+08,2.49543e+09,1.0373e+07
19911030,513300,418000,95300,82406,7.12969e+08,2.50586e+09,1.06752e+07
19911031,512400,421800,90600,33510,7.17035e+08,2.50404e+09,1.10392e+07
19911101,517300,411100,106200,-16771,7.15669e+08,2.51099e+09,1.16677e+07
19911104,518500,404800,113700,-52368,7.10104e+08,2.50283e+09,1.12631e+07
19911105,520300,389300,131000,21109,7.10811e+08,2.51264e+09,1.02706e+07
19911106,521100,375900,145200,54433,7.17141e+08,2.51913e+09,9.23793e+06
19911107,520900,368200,152700,79940,7.28091e+08,2.54689e+09,8.84485e+06
19911108,520900,396300,124600,-37200,7.20502e+08,2.54868e+09,8.97472e+06
19911111,519900,400600,119300,24692,7.23495e+08,2.55096e+09,9.10935e+06
19911112,518500,412600,105900,90410,7.35499e+08,2.56577e+09,9.80817e+06
19911113,515300,437300,78000,10709,7.37153e+08,2.56335e+09,1.04111e+07
19911114,514000,431900,82100,-3377,7.34849e+08,2.55186e+09,1.05995e+07
19911115,514800,416100,98700,-304305,6.94801e+08,2.47653e+09,9.4165e+06
19911118,514000,401300,112700,-19445,6.93613e+08,2.47726e+09,8.87278e+06
19911119,514600,378800,135800,-120461,6.77412e+08,2.43786e+09,6.93008e+06
19911120,518400,300300,218100,11905,6.80125e+08,2.43529e+09,3.30041e+06
19911121,520500,249100,271400,26032,6.83941e+08,2.45708e+09,-573063
19911122,517500,198900,318600,31554,6.88683e+08,2.42703e+09,-2.98389e+06
19911125,516400,187200,329200,39997,6.95244e+08,2.41455e+09,-3.93139e+06
19911126,515900,182100,333800,6561,6.96895e+08,2.427e+09,-4.43153e+06
19911127,517700,176500,341200,38590,6.99496e+08,2.43301e+09,-4.36539e+06
19911129,517800,178300,339500,12469,7.00356e+08,2.42982e+09,-4.2086e+06
19911202,517100,188500,328600,-69112,6.90764e+08,2.45692e+09,-3.45961e+06
19911203,520200,180400,339800,35148,6.95822e+08,2.47641e+09,-2.59208e+06
19911204,519700,195800,323900,21160,7.00515e+08,2.47422e+09,-1.22486e+06
19911205,519100,202100,317000,17823,7.02293e+08,2.46144e+09,-854447
19911206,525400,242700,282700,53447,7.08553e+08,2.53344e+09,1.48916e+06
19911209,523600,267600,256000,24821,7.1337e+08,2.51803e+09,2.77993e+06
19911210,524000,273500,250500,11769,7.15744e+08,2.51814e+09,3.29626e+06
19911211,523800,282600,241200,-9570,7.13543e+08,2.51203e+09,3.77103e+06
19911212,523800,285700,238100,4980,7.1403e+08,2.53489e+09,3.98703e+06
19911213,523900,308700,215200,51062,7.19895e+08,2.55907e+09,5.52265e+06
19911216,522200,319300,202900,26714,7.23608e+08,2.55916e+09,6.42924e+06
19911217,523900,328200,195700,-44751,7.15909e+08,2.54198e+09,7.1424e+06
19911218,524600,325700,198900,30162,7.19642e+08,2.55055e+09,7.62755e+06
19911219,524700,342000,182700,-7027,7.20444e+08,2.53991e+09,8.1885e+06
19911220,525200,335200,190000,36089,7.2789e+08,2.56186e+09,7.74669e+06
19911223,524800,344700,180100,190927,7.54379e+08,2.61737e+09,8.2473e+06
19911224,523400,362100,161300,38858,7.53193e+08,2.63726e+09,9.1893e+06
19911226,521600,399500,122100,175465,7.73781e+08,2.66429e+09,1.05183e+07
19911227,519800,410100,109700,102669,7.85094e+08,2.66634e+09,1.17319e+07
19911230,519000,429700,89300,308411,8.29017e+08,2.72387e+09,1.3094e+07
19911231,517500,456300,61200,115059,8.46584e+08,2.73197e+09,1.42196e+07
19920102,516200,461100,55100,-70502,8.36956e+08,2.71454e+09,1.43756e+07
19920103,516100,469200,46900,69122,8.44623e+08,2.71712e+09,1.46593e+07
19920106,515400,473400,42000,21047,8.49362e+08,2.7115e+09,1.47776e+07
19920107,512100,493400,18700,6093,8.52474e+08,2.70522e+09,1.51582e+07
19920108,512000,495700,16300,113793,8.688e+08,2.72122e+09,1.53865e+07
19920109,513800,492100,21700,123109,8.82998e+08,2.75304e+09,1.55077e+07
19920110,514000,479800,34200,-92583,8.6949e+08,2.74775e+09,1.4708e+07
19920113,514200,477200,37000,16206,8.7166e+08,2.74503e+09,1.44881e+07
19920114,516700,471000,45700,205928,8.98704e+08,2.7999e+09,1.41661e+07
19920115,518400,466300,52100,146296,9.11884e+08,2.84512e+09,1.37598e+07
19920116,518100,448800,69300,21247,9.12335e+08,2.83451e+09,1.22933e+07
19920117,517800,449800,68000,-27581,9.08451e+08,2.82865e+09,1.21458e+07
19920120,517400,449800,67600,-152164,8.89707e+08,2.8025e+09,1.16298e+07
19920121,518300,440100,78200,-245230,8.59494e+08,2.75762e+09,1.03071e+07
19920122,516800,408100,108700,101392,8.71913e+08,2.79063e+09,8.23146e+06
19920123,516700,394000,122700,21984,8.75738e+08,2.78385e+09,6.91675e+06
19920124,516300,388600,127700,9828,8.75495e+08,2.78436e+09,6.32423e+06
19920127,515500,382900,132600,-2374,8.76278e+08,2.77408e+09,5.92828e+06
19920128,514500,385700,128800,17755,8.7594e+08,2.77402e+09,6.52248e+06
19920129,515600,370300,145300,-28489,8.69736e+08,2.76152e+09,5.80129e+06
19920130,515100,349300,165800,12239,8.6916e+08,2.77951e+09,4.80197e+06
19920131,514900,340500,174400,-8124,8.6819e+08,2.76862e+09,4.53707e+06
19920203,513500,327700,185800,3644,8.68167e+08,2.76278e+09,3.79066e+06
19920204,512600,332400,180200,10682,8.70666e+08,2.78316e+09,4.28983e+06
19920205,512300,330400,181900,39206,8.75716e+08,2.79829e+09,4.72462e+06
19920206,505400,320200,185200,-881,8.7792e+08,2.76643e+09,5.52002e+06
19920207,504100,324900,179200,-40402,8.69866e+08,2.74512e+09,6.05701e+06
19920210,501200,334100,167100,59420,8.76657e+08,2.73593e+09,6.56697e+06
19920211,499900,330600,169300,41752,8.82352e+08,2.73068e+09,6.19166e+06
19920212,496400,338000,158400,85064,8.88692e+08,2.74549e+09,6.9784e+06
19920213,495600,361100,134500,-61489,8.82702e+08,2.72053e+09,8.1325e+06
19920214,494100,371900,122200,-13538,8.82869e+08,2.70275e+09,8.81847e+06
19920218,494300,365300,129000,3585,8.82827e+08,2.67899e+09,8.18947e+06
19920219,497600,360100,137500,-14723,8.81207e+08,2.69739e+09,7.37262e+06
19920220,497400,345700,151700,80181,8.90803e+08,2.73678e+09,6.36687e+06
19920221,497100,340100,157000,-29963,8.87911e+08,2.72047e+09,5.98126e+06
19920224,497100,323600,173500,989,8.86413e+08,2.71796e+09,5.36857e+06
19920225,498400,324000,174400,-64310,8.81644e+08,2.7144e+09,5.33366e+06
19920226,495100,304000,191100,-49872,8.73137e+08,2.71721e+09,5.33828e+06
19920227,495200,301700,193500,-28276,8.70993e+08,2.71455e+09,5.22255e+06
19920228,491900,292000,199900,-6852,8.68706e+08,2.69164e+09,4.76042e+06
19920302,492700,307900,184800,5656,8.69991e+08,2.70213e+09,5.63219e+06
19920303,491900,332200,159700,16502,8.72266e+08,2.70103e+09,6.75603e+06
19920304,491300,336600,154700,-17445,8.70773e+08,2.68641e+09,6.59125e+06
19920305,491000,324500,166500,-63698,8.61008e+08,2.65721e+09,5.5294e+06
19920306,489500,314900,174600,-46954,8.56285e+08,2.63324e+09,4.82791e+06
19920309,481700,275800,205900,-16678,8.538e+08,2.62372e+09,3.4609e+06
19920310,482600,260600,222000,-44724,8.48944e+08,2.63111e+09,2.10889e+06
19920311,481900,236400,245500,2848,8.47403e+08,2.61115e+09,514085
19920312,485400,241800,243600,-17010,8.43848e+08,2.62053e+09,340432
19920313,484500,229200,255300,-13923,8.44185e+08,2.63855e+09,687184
19920316,484600,239000,245600,28250,8.48982e+08,2.64316e+09,935698
19920317,485500,243000,242500,-61831,8.44163e+08,2.65398e+09,1.27958e+06
19920318,485300,255700,229600,24564,8.45595e+08,2.66204e+09,2.30103e+06
19920319,483700,284300,199400,38540,8.50281e+08,2.66058e+09,4.46186e+06
19920320,485500,294200,191300,30959,8.55243e+08,2.66762e+09,5.02705e+06
19920323,485400,309400,176000,-45527,8.47307e+08,2.65492e+09,6.21468e+06
19920324,485000,315300,169700,-43576,8.41601e+08,2.64462e+09,6.64577e+06
19920325,485400,320600,164800,1502,8.41282e+08,2.63923e+09,6.90756e+06
19920326,485200,315600,169600,24779,8.44556e+08,2.63663e+09,6.55978e+06
19920327,486500,300200,186300,-64508,8.3144e+08,2.60885e+09,5.65916e+06
19920330,487000,292900,194100,-35886,8.26657e+08,2.6061e+09,5.1466e+06
19920331,486800,282400,204400,-36797,8.20835e+08,2.60784e+09,4.15896e+06
19920401,487300,278100,209200,-8438,8.1905e+08,2.61346e+09,3.79678e+06
19920402,489000,269300,219700,5422,8.23505e+08,2.60553e+09,3.00115e+06
19920403,492100,264800,227300,19812,8.32144e+08,2.59996e+09,2.09864e+06
19920406,492800,245400,247400,7075,8.35805e+08,2.62956e+09,1.3841e+06
19920407,494100,232700,261400,92025,8.51521e+08,2.5842e+09,525168
19920408,496300,208300,288000,34767,8.55212e+08,2.56641e+09,-1.20519e+06
19920409,497100,198200,298900,-82897,8.46211e+08,2.61591e+09,-1.97459e+06
19920410,500800,204000,296800,54411,8.52804e+08,2.63961e+09,-1.54225e+06
19920413,507800,199900,307900,-16878,8.51483e+08,2.71236e+09,-1.88592e+06
19920414,509200,237200,272000,-17459,8.47742e+08,2.76975e+09,430371
19920415,512300,278500,233800,50785,8.52402e+08,2.79456e+09,3.32684e+06
19920416,511600,311300,200300,4425,8.53184e+08,2.78194e+09,6.32604e+06
19920420,510700,332200,178500,-84565,8.44094e+08,2.73457e+09,7.74742e+06
19920421,510500,336000,174500,-12897,8.40415e+08,2.71795e+09,7.90596e+06
19920422,513100,335000,178100,-2954,8.38975e+08,2.73397e+09,7.58926e+06
19920423,515200,345600,169600,64199,8.45524e+08,2.75149e+09,7.11272e+06
19920424,517000,331800,185200,-3351,8.45849e+08,2.75379e+09,5.83235e+06
19920427,516400,325600,190800,-19366,8.43564e+08,2.73483e+09,5.45486e+06
19920428,520100,304300,215800,31730,8.50378e+08,2.74134e+09,4.43785e+06
19920429,524300,323800,200500,-24983,8.46485e+08,2.78607e+09,4.84052e+06
19920430,523400,323800,199600,7327,8.46217e+08,2.80385e+09,4.9712e+06
19920501,523900,328400,195500,-44134,8.39897e+08,2.79786e+09,5.20918e+06
19920504,524000,346700,177300,27055,8.4676e+08,2.82494e+09,6.55788e+06
19920505,522700,379200,143500,14717,8.45936e+08,2.82618e+09,8.25121e+06
19920506,523000,414200,108800,35782,8.51472e+08,2.83433e+09,9.87671e+06
19920507,526500,426400,100100,-16861,8.50182e+08,2.84891e+09,1.01274e+07
19920508,526900,443900,83000,-27148,8.46114e+08,2.85432e+09,1.08679e+07
19920511,528200,442700,85500,102925,8.57516e+08,2.87007e+09,1.11199e+07
19920512,528500,447100,81400,-104110,8.43094e+08,2.84024e+09,1.13855e+07
19920513,530100,434400,95700,8410,8.44064e+08,2.83533e+09,1.10561e+07
19920514,531200,420800,110400,-94122,8.32631e+08,2.80371e+09,1.04818e+07
19920515,533200,407700,125500,-20707,8.29273e+08,2.7979e+09,9.58198e+06
19920518,537300,377300,160000,-44502,8.24469e+08,2.78141e+09,8.1813e+06
19920519,539900,364700,175200,68114,8.34416e+08,2.80254e+09,7.82914e+06
19920520,539300,367900,171400,-13830,8.31995e+08,2.80297e+09,7.52755e+06
19920521,541600,364000,177600,-64116,8.23018e+08,2.79397e+09,7.27474e+06
19920522,542100,362500,179600,-4736,8.23236e+08,2.80365e+09,7.17167e+06
19920526,542200,353400,188800,-35290,8.20371e+08,2.75029e+09,6.41145e+06
19920527,542900,340900,202000,-577,8.17854e+08,2.76085e+09,5.6879e+06
19920528,543600,333600,210000,63638,8.26569e+08,2.79038e+09,4.56612e+06
19920529,542700,344000,198700,-40842,8.20957e+08,2.79692e+09,4.54838e+06
19920601,545100,372200,172900,-1481,8.18119e+08,2.82674e+09,5.63972e+06
19920602,542500,389800,152700,48231,8.2306e+08,2.79238e+09,6.8909e+06
19920603,540300,406200,134100,2970,8.22716e+08,2.78167e+09,7.71683e+06
19920604,540000,399100,140900,15146,8.22978e+08,2.77066e+09,7.58747e+06
19920605,542500,399600,142900,-7898,8.23073e+08,2.78171e+09,7.48315e+06
19920608,542200,407700,134500,-10839,8.2323e+08,2.77432e+09,7.65723e+06
19920609,543300,390600,152700,-38921,8.16539e+08,2.75355e+09,6.55361e+06
19920610,545000,372000,173000,11800,8.17839e+08,2.73415e+09,5.63874e+06
19920611,547200,361600,185600,11773,8.18291e+08,2.74919e+09,5.31091e+06
19920612,548900,348500,200400,18595,8.19853e+08,2.77039e+09,4.17149e+06
19920615,547000,315800,231200,49434,8.21055e+08,2.73943e+09,2.88764e+06
19920616,551000,292500,258500,655,8.23479e+08,2.76064e+09,1.97838e+06
19920617,554400,271800,282600,-9484,8.20962e+08,2.7341e+09,690489
19920618,555800,274800,281000,8007,8.22504e+08,2.72719e+09,385195
19920619,558500,227200,331300,-7326,8.21651e+08,2.75324e+09,-1.38203e+06
19920622,561400,187100,374300,-1904,8.24703e+08,2.72467e+09,-3.26938e+06
19920623,562400,165500,396900,-17612,8.26768e+08,2.73777e+09,-4.33757e+06
19920624,561500,168400,393100,-16248,8.24824e+08,2.72928e+09,-4.12158e+06
19920625,561000,194400,366600,29173,8.26555e+08,2.72119e+09,-2.52907e+06
19920626,560800,200700,360100,7182,8.26952e+08,2.7253e+09,-2.58419e+06
19920629,563800,235800,328000,19385,8.2947e+08,2.77144e+09,-126639
19920630,562800,263700,299100,6547,8.30653e+08,2.78047e+09,1.33188e+06
19920701,560100,300800,259300,2839,8.34647e+08,2.78869e+09,3.39526e+06
19920702,560200,337400,222800,-16647,8.32812e+08,2.76873e+09,5.86021e+06
19920706,558700,363900,194800,41192,8.3773e+08,2.76388e+09,7.02772e+06
19920707,560100,379800,180300,-61343,8.30042e+08,2.73537e+09,7.75193e+06
19920708,560300,383300,177000,28971,8.32465e+08,2.73614e+09,7.77742e+06
19920709,566000,388300,177700,87905,8.46923e+08,2.80156e+09,7.96264e+06
19920710,565900,399300,166600,17173,8.48791e+08,2.80305e+09,8.02901e+06
19920713,565600,401500,164100,17069,8.49086e+08,2.80811e+09,7.90242e+06
19920714,567800,424700,143100,72083,8.59159e+08,2.82436e+09,9.14387e+06
19920715,572600,442700,129900,17132,8.59612e+08,2.84572e+09,1.02458e+07
19920716,573100,451500,121600,-59649,8.54362e+08,2.84264e+09,1.07398e+07
19920717,577100,473700,103400,-70665,8.43438e+08,2.85162e+09,1.13351e+07
19920720,577800,481600,96200,-35444,8.3658e+08,2.84143e+09,1.12918e+07
19920721,578700,466600,112100,70568,8.45005e+08,2.85735e+09,1.02941e+07
19920722,582000,448700,133300,-955,8.44561e+08,2.86006e+09,9.46769e+06
19920723,585900,434900,151000,55270,8.53029e+08,2.89333e+09,8.85458e+06
19920724,589400,424000,165400,20207,8.55081e+08,2.92732e+09,8.34468e+06
19920727,589900,422800,167100,2609,8.54853e+08,2.93447e+09,8.12146e+06
19920728,590200,422900,167300,90362,8.67917e+08,2.9746e+09,8.22418e+06
19920729,590000,443400,146600,73375,8.79982e+08,3.00554e+09,9.15466e+06
19920730,586900,468900,118000,49391,8.874e+08,2.99603e+09,1.01597e+07
19920731,585300,482300,103000,32967,8.89954e+08,2.98185e+09,1.13338e+07
19920803,584700,506900,77800,-14357,8.89414e+08,2.97601e+09,1.27974e+07
19920804,584300,508600,75700,-21056,8.83392e+08,2.97219e+09,1.31366e+07
19920805,583600,506000,77600,-53265,8.76002e+08,2.95599e+09,1.29429e+07
19920806,583800,504100,79700,-42333,8.70995e+08,2.94577e+09,1.29016e+07
19920807,584300,505700,78600,-20211,8.68315e+08,2.93893e+09,1.29039e+07
19920810,584100,492500,91600,-15744,8.65939e+08,2.93432e+09,1.21658e+07
19920811,583900,479000,104900,-32778,8.61131e+08,2.92562e+09,1.14231e+07
19920812,584300,474300,110000,3521,8.61687e+08,2.91872e+09,1.07997e+07
19920813,584100,464300,119800,4815,8.59449e+08,2.91248e+09,1.03483e+07
19920814,584600,454900,129700,44400,8.64855e+08,2.92578e+09,9.81306e+06
19920817,586100,436500,149600,2857,8.65056e+08,2.93069e+09,8.26535e+06
19920818,586400,435300,151100,20637,8.68765e+08,2.93245e+09,8.2765e+06
19920819,585800,410400,175400,-51338,8.63317e+08,2.90971e+09,7.36643e+06
19920820,587800,388500,199300,9243,8.67896e+08,2.9198e+09,6.53273e+06
19920821,588500,374100,214400,-42755,8.63264e+08,2.90743e+09,5.65865e+06
19920824,589200,351600,237600,-56084,8.54433e+08,2.87079e+09,4.39404e+06
19920825,591200,313500,277700,-3705,8.51113e+08,2.87445e+09,2.73906e+06
19920826,592100,268000,324100,18768,8.55866e+08,2.89473e+09,603277
19920827,592300,260900,331400,-26718,8.52553e+08,2.90797e+09,104700
19920828,591700,262700,329000,20470,8.57968e+08,2.91551e+09,-258930
19920831,589100,263300,325800,47453,8.63282e+08,2.8921e+09,-470675
19920901,588400,287100,301300,-655,8.63365e+08,2.90295e+09,1.08734e+06
19920902,584600,315700,268900,6911,8.59683e+08,2.90861e+09,2.85421e+06
19920903,583800,345700,238100,12364,8.60019e+08,2.9064e+09,4.70523e+06
19920904,583700,394500,189200,-22327,8.58124e+08,2.89751e+09,5.97367e+06
19920908,582900,412100,170800,-3594,8.58204e+08,2.87888e+09,7.12865e+06
19920909,584700,426200,158500,46712,8.64255e+08,2.89491e+09,7.63892e+06
19920910,583200,429900,153300,88102,8.7819e+08,2.911e+09,8.06072e+06
19920911,583000,426400,156600,25529,8.82028e+08,2.91747e+09,8.07346e+06
19920914,582300,462100,120200,178486,9.03867e+08,2.95851e+09,9.91472e+06
19920915,580900,480200,100700,-119021,8.85235e+08,2.92801e+09,1.06252e+07
19920916,580900,487700,93200,-32526,8.85288e+08,2.90187e+09,1.12803e+07
19920917,580700,476100,104600,48976,8.92176e+08,2.90665e+09,1.09491e+07
19920918,580400,476800,103600,17244,8.94828e+08,2.91797e+09,1.08521e+07
19920921,581300,481700,99600,-37350,8.9268e+08,2.90251e+09,1.10492e+07
19920922,581100,475000,106100,-106797,8.78692e+08,2.87656e+09,1.06683e+07
19920923,582700,461500,121200,-4407,8.79291e+08,2.87727e+09,1.02157e+07
19920924,584200,450300,133900,59139,8.8942e+08,2.89925e+09,9.22074e+06
19920925,586300,425200,161100,-67824,8.80692e+08,2.88228e+09,8.423e+06
19920928,587100,417100,170000,31084,8.8506e+08,2.89682e+09,7.95208e+06
19920929,587600,399500,188100,-7061,8.82269e+08,2.90849e+09,7.12575e+06
19920930,587300,398000,189300,75631,8.90095e+08,2.91971e+09,7.32138e+06
19921001,588100,382700,205400,-12419,8.9006e+08,2.9182e+09,6.23736e+06
19921002,589000,368100,220900,-37516,8.85517e+08,2.88653e+09,5.57844e+06
19921005,589900,331100,258800,-2422,8.84767e+08,2.87044e+09,3.8832e+06
19921006,591500,312500,279000,-11206,8.81204e+08,2.88741e+09,3.17658e+06
19921007,592600,280100,312500,26331,8.83649e+08,2.88264e+09,819950
19921008,593500,260800,332700,5585,8.86914e+08,2.91067e+09,-342730
19921009,591800,251800,340000,60245,8.95814e+08,2.87306e+09,-682551
19921012,590500,273500,317000,-27044,8.91608e+08,2.89653e+09,-103513
19921013,589400,289700,299700,-24215,8.88416e+08,2.90269e+09,571184
19921014,587100,303100,284000,24226,8.89739e+08,2.88851e+09,1.42629e+06
19921015,586800,313100,273700,49154,8.94703e+08,2.88605e+09,2.32008e+06
19921016,585100,345400,239700,68092,9.02767e+08,2.90342e+09,4.20058e+06
19921019,582600,382000,200600,103645,9.1801e+08,2.93331e+09,6.63515e+06
19921020,586400,407900,178500,-7271,9.15932e+08,2.94744e+09,8.26064e+06
19921021,583200,440800,142400,67720,9.2518e+08,2.93925e+09,1.05498e+07
19921022,582400,442000,140400,6611,9.26238e+08,2.93499e+09,1.07678e+07
19921023,580400,474100,106300,9931,9.24562e+08,2.9311e+09,1.18151e+07
19921026,580700,498600,82100,119715,9.43051e+08,2.95016e+09,1.2781e+07
19921027,580200,499300,80900,-12779,9.39768e+08,2.94362e+09,1.26331e+07
19921028,579300,497800,81500,101321,9.52709e+08,2.95295e+09,1.2841e+07
19921029,578700,502700,76000,48526,9.57987e+08,2.96206e+09,1.32412e+07
19921030,580300,490000,90300,-48514,9.51099e+08,2.95622e+09,1.2487e+07
19921102,579600,508200,71400,132365,9.69089e+08,2.97489e+09,1.3069e+07
19921103,579700,514500,65200,-41166,9.617e+08,2.9708e+09,1.32626e+07
19921104,579700,528600,51100,-23894,9.5925e+08,2.96284e+09,1.35828e+07
19921105,580100,528600,51500,88269,9.73755e+08,2.97238e+09,1.33523e+07
19921106,580200,524900,55300,52728,9.8304e+08,2.98108e+09,1.32798e+07
19921109,578800,505800,73000,63718,9.90057e+08,2.99294e+09,1.22531e+07
19921110,578600,502200,76400,50415,9.94607e+08,2.99866e+09,1.20427e+07
19921111,578400,494300,84100,107573,1.00781e+09,3.01978e+09,1.16738e+07
19921112,577700,502500,75200,-1075,1.00967e+09,3.0149e+09,1.17658e+07
19921113,579100,506500,72600,162,1.01016e+09,3.02973e+09,1.21498e+07
19921116,579200,505600,73600,-75819,1.00069e+09,3.0042e+09,1.23277e+07
19921117,579800,494000,85800,-63611,9.90965e+08,2.98892e+09,1.15478e+07
19921118,580000,482300,97700,104191,1.00499e+09,3.0139e+09,1.11728e+07
19921119,579600,479200,100400,43580,1.01061e+09,3.01822e+09,1.12253e+07
19921120,578700,467400,111300,94429,1.02342e+09,3.04132e+09,1.11765e+07
19921123,577200,467700,109500,-13568,1.02101e+09,3.02424e+09,1.12526e+07
19921124,574400,457200,117200,94813,1.03254e+09,3.03675e+09,1.13043e+07
19921125,573900,455500,118400,34639,1.03606e+09,3.04446e+09,1.10751e+07
19921127,572900,458900,114000,59157,1.04491e+09,3.05125e+09,1.13384e+07
19921130,572200,468700,103500,59319,1.0552e+09,3.06211e+09,1.2206e+07
19921201,570800,474200,96600,-21190,1.05221e+09,3.0559e+09,1.26446e+07
19921202,569900,477300,92600,-13286,1.05103e+09,3.04347e+09,1.27012e+07
19921203,567600,481600,86000,-12662,1.049e+09,3.0398e+09,1.27909e+07
19921204,567300,495200,72100,68130,1.05589e+09,3.04788e+09,1.32401e+07
19921207,564400,486800,77600,88918,1.06796e+09,3.05185e+09,1.30259e+07
19921208,564500,487700,76800,63806,1.07629e+09,3.0661e+09,1.31002e+07
19921209,558700,485600,73100,-2921,1.07204e+09,3.0297e+09,1.32858e+07
19921210,558800,485400,73400,-107248,1.05846e+09,3.00946e+09,1.29912e+07
19921211,557400,484600,72800,-17575,1.05761e+09,2.99263e+09,1.28234e+07
19921214,555200,475900,79300,-18212,1.05577e+09,2.98432e+09,1.24264e+07
19921215,552400,454000,98400,186,1.05765e+09,2.95647e+09,1.12424e+07
19921216,553700,441700,112000,-42029,1.05315e+09,2.95416e+09,1.02462e+07
19921217,552400,437600,114800,77914,1.0603e+09,2.97866e+09,1.01887e+07
19921218,550600,413300,137300,89894,1.0727e+09,2.98374e+09,9.37721e+06
19921221,550300,410900,139400,11218,1.07693e+09,2.97996e+09,9.38472e+06
19921222,547400,412300,135100,33161,1.08055e+09,2.96295e+09,1.01184e+07
19921223,543700,414200,129500,-21799,1.07852e+09,2.94664e+09,1.0248e+07
19921224,540100,421500,118600,11251,1.07909e+09,2.92997e+09,1.03626e+07
19921228,538800,420600,118200,11153,1.0803e+09,2.92307e+09,1.03482e+07
19921229,536800,417800,119000,22505,1.08291e+09,2.9218e+09,1.00827e+07
19921230,536300,424100,112200,35594,1.08752e+09,2.93032e+09,1.03536e+07
19921231,535500,437600,97900,41415,1.09386e+09,2.9219e+09,1.09856e+07
19930104,534100,443300,90800,-84341,1.0827e+09,2.90231e+09,1.12375e+07
19930105,532300,447100,85200,-17540,1.07804e+09,2.8826e+09,1.11664e+07
19930106,530600,458500,72100,113844,1.09569e+09,2.88742e+09,1.14936e+07
19930107,530000,453300,76700,-49558,1.08828e+09,2.86353e+09,1.11617e+07
19930108,531200,428300,102900,-21447,1.0851e+09,2.8602e+09,9.24781e+06
19930111,532200,416700,115500,1161,1.08677e+09,2.87304e+09,8.44535e+06
19930112,531900,394800,137100,-23203,1.08536e+09,2.86715e+09,7.20842e+06
19930113,532000,385000,147000,84107,1.09576e+09,2.88436e+09,6.68728e+06
19930114,530700,381800,148900,95336,1.10669e+09,2.90587e+09,6.74213e+06
19930115,530100,377300,152800,-4177,1.1048e+09,2.91476e+09,6.48703e+06
19930118,529600,394200,135400,39263,1.11356e+09,2.91259e+09,8.12907e+06
19930119,527900,407600,120300,700,1.11224e+09,2.88273e+09,8.93492e+06
19930120,524900,408800,116100,-28607,1.10878e+09,2.87062e+09,9.0702e+06
19930121,524400,409300,115100,43019,1.11492e+09,2.88004e+09,9.23936e+06
19930122,523200,413200,110000,32076,1.12179e+09,2.88415e+09,9.47307e+06
19930125,535900,422500,113400,86054,1.1308e+09,2.93766e+09,9.72776e+06
19930126,535700,428900,106800,20824,1.13363e+09,2.93332e+09,1.02405e+07
19930127,534200,423100,111100,-123378,1.12146e+09,2.88773e+09,9.92986e+06
19930128,535200,426200,109000,-15417,1.12012e+09,2.89146e+09,1.04338e+07
19930129,534400,432300,102100,26204,1.12269e+09,2.89559e+09,1.03227e+07
19930201,534100,427500,106600,128615,1.13939e+09,2.93334e+09,1.00911e+07
19930202,533100,429100,104000,67762,1.14754e+09,2.9396e+09,1.0425e+07
19930203,530800,433000,97800,135533,1.16434e+09,2.96228e+09,1.10876e+07
19930204,526900,433000,93900,121242,1.18177e+09,2.96001e+09,1.15836e+07
19930205,523800,436900,86900,-41644,1.17715e+09,2.92195e+09,1.19605e+07
19930208,521000,434000,87000,12688,1.1784e+09,2.89737e+09,1.16157e+07
19930209,520900,431200,89700,-110660,1.16292e+09,2.87276e+09,1.11192e+07
19930210,519600,417200,102400,-18768,1.16153e+09,2.87412e+09,1.03545e+07
19930211,519200,409100,110100,44216,1.16645e+09,2.87712e+09,9.88825e+06
19930212,519600,384900,134700,-60881,1.15629e+09,2.85815e+09,8.72706e+06
19930216,519600,372400,147200,-129700,1.13913e+09,2.77278e+09,7.71331e+06
19930217,521100,349000,172100,-23993,1.13407e+09,2.76124e+09,6.26225e+06
19930218,523800,308500,215300,-7995,1.13464e+09,2.77467e+09,3.59056e+06
19930219,524100,270400,253700,127868,1.15377e+09,2.78502e+09,1.36169e+06
19930222,521400,239000,282400,194237,1.18305e+09,2.74261e+09,-1.14464e+06
19930223,524700,237900,286800,1696,1.17991e+09,2.7624e+09,-1.49442e+06
19930224,524400,254300,270100,-107957,1.1655e+09,2.80823e+09,-1.08679e+06
19930225,521800,262100,259700,-33298,1.16197e+09,2.80974e+09,-419994
19930226,521100,279400,241700,-25174,1.15668e+09,2.79834e+09,836256
19930301,521300,280400,240900,85814,1.17385e+09,2.78148e+09,1.56486e+06
19930302,520800,306500,214300,37551,1.1791e+09,2.82009e+09,3.76156e+06
19930303,521000,340600,180400,58572,1.18733e+09,2.84206e+09,6.01676e+06
19930304,521500,374200,147300,2640,1.18679e+09,2.83837e+09,7.97112e+06
19930305,521900,392100,129800,-25418,1.18461e+09,2.8481e+09,8.96189e+06
19930308,525700,420400,105300,75057,1.19371e+09,2.92045e+09,1.0927e+07
19930309,526700,440900,85800,65434,1.20231e+09,2.92642e+09,1.25427e+07
19930310,526400,459500,66900,36000,1.20912e+09,2.93501e+09,1.34341e+07
19930311,525200,469700,55500,-14574,1.20722e+09,2.92468e+09,1.41728e+07
19930312,524200,469400,54800,-88710,1.19507e+09,2.89575e+09,1.4028e+07
19930315,525100,475500,49600,67218,1.20346e+09,2.91565e+09,1.44647e+07
19930316,525800,467100,58700,12117,1.20817e+09,2.92283e+09,1.43307e+07
19930317,526300,456500,69800,-104020,1.19253e+09,2.89937e+09,1.33953e+07
19930318,526700,451700,75000,58153,1.20057e+09,2.91196e+09,1.2959e+07
19930319,527700,437000,90700,-32937,1.19676e+09,2.90648e+09,1.18451e+07
19930322,530300,416000,114300,-31699,1.18872e+09,2.91093e+09,1.07533e+07
19930323,532700,406200,126500,-30488,1.18548e+09,2.93287e+09,9.72807e+06
19930324,533400,374900,158500,74606,1.19476e+09,2.93774e+09,8.23703e+06
19930325,533700,360100,173600,39436,1.20167e+09,2.96305e+09,7.57853e+06
19930326,533000,352200,180800,-27304,1.20023e+09,2.93809e+09,6.86657e+06
19930329,533600,353500,180100,20962,1.20378e+09,2.95791e+09,6.89206e+06
19930330,532600,351200,181400,-15699,1.20006e+09,2.95418e+09,6.86197e+06
19930331,533100,378600,154500,15334,1.20005e+09,2.97263e+09,7.87621e+06
19930401,532000,376500,155500,-5313,1.19848e+09,2.95978e+09,7.86691e+06
19930402,533000,365700,167300,-112115,1.18606e+09,2.90236e+09,7.52739e+06
19930405,532500,350900,181600,24674,1.18993e+09,2.9063e+09,6.35855e+06
19930406,533100,314400,218700,45983,1.19705e+09,2.89393e+09,4.46157e+06
19930407,533300,290800,242500,53150,1.20295e+09,2.90783e+09,2.84337e+06
19930408,533300,265600,267700,44653,1.20981e+09,2.90767e+09,1.16626e+06
19930412,533000,258800,274200,-5294,1.20698e+09,2.94576e+09,1.04622e+06
19930413,531500,272500,259000,32321,1.21e+09,2.94831e+09,2.37278e+06
19930414,528700,306100,222600,52617,1.21812e+09,2.91753e+09,3.8635e+06
19930415,528700,314800,213900,9606,1.21846e+09,2.90948e+09,4.85285e+06
19930416,531400,326200,205200,38555,1.22184e+09,2.91935e+09,5.05463e+06
19930419,531500,337000,194500,-1641,1.2214e+09,2.90962e+09,5.5546e+06
19930420,529600,327500,202100,-66487,1.2114e+09,2.88771e+09,5.21997e+06
19930421,530000,328600,201400,-68435,1.20399e+09,2.88706e+09,4.69801e+06
19930422,526300,309400,216900,-50884,1.19797e+09,2.85474e+09,3.56141e+06
19930423,528400,296400,232000,855,1.20017e+09,2.84729e+09,2.65316e+06
19930426,528100,285800,242300,33220,1.20296e+09,2.8136e+09,1.4477e+06
19930427,529600,268700,260900,840,1.2028e+09,2.84002e+09,179280
19930428,531600,283100,248500,-21291,1.20057e+09,2.86969e+09,-45688
19930429,531500,285200,246300,-12239,1.19749e+09,2.87816e+09,304131
19930430,534700,274200,260500,-5632,1.19921e+09,2.9237e+09,192139
19930503,534100,290500,243600,56819,1.20592e+09,2.93601e+09,1.16883e+06
19930504,533300,329600,203700,48441,1.21166e+09,2.9511e+09,3.44022e+06
19930505,534100,362800,171300,64335,1.22502e+09,2.93224e+09,5.43552e+06
19930506,535700,389000,146700,-10447,1.22017e+09,2.94418e+09,7.06329e+06
19930507,536700,415500,121200,92,1.22123e+09,2.94474e+09,8.03381e+06
19930510,537000,413700,123300,22439,1.22134e+09,2.95701e+09,7.9057e+06
19930511,532800,421200,111600,33481,1.22576e+09,2.92726e+09,8.88181e+06
19930512,533600,423200,110400,-10943,1.22667e+09,2.93298e+09,9.2518e+06
19930513,533400,419700,113700,-84458,1.21383e+09,2.89614e+09,8.91371e+06
19930514,533900,419300,114600,48009,1.22141e+09,2.89193e+09,9.18363e+06
19930517,534900,406300,128600,41810,1.22859e+09,2.89704e+09,8.30587e+06
19930518,535500,396500,139000,44052,1.23422e+09,2.90013e+09,7.6436e+06
19930519,535700,386800,148900,69534,1.24248e+09,2.94405e+09,6.87149e+06
19930520,538800,396100,142700,86395,1.25172e+09,2.9799e+09,7.37636e+06
19930521,538500,405300,133200,-23972,1.2462e+09,2.96245e+09,7.86231e+06
19930524,538100,404300,133800,178,1.24624e+09,2.96659e+09,7.85926e+06
19930525,538500,404700,133800,-20704,1.24438e+09,2.979e+09,8.55372e+06
19930526,538000,418700,119300,138309,1.26725e+09,3.00625e+09,9.52127e+06
19930527,538200,409900,128300,8100,1.2681e+09,3.00017e+09,9.77534e+06
19930528,537700,420300,117400,-66102,1.25794e+09,2.97974e+09,1.02553e+07
19930601,536900,432500,104400,88748,1.27252e+09,2.99558e+09,1.12763e+07
19930602,535400,438600,96800,4640,1.27377e+09,2.98668e+09,1.19717e+07
19930603,530400,420100,110300,-11735,1.27026e+09,2.97122e+09,1.14073e+07
19930604,532100,413700,118400,-70138,1.25887e+09,2.9552e+09,1.13833e+07
19930607,531800,412600,119200,-118788,1.24189e+09,2.9199e+09,1.11002e+07
19930608,533400,392600,140800,-73165,1.2328e+09,2.9035e+09,9.51654e+06
19930609,534600,367900,166700,29014,1.23909e+09,2.90926e+09,7.63895e+06
19930610,535000,355100,179900,-53170,1.22996e+09,2.90269e+09,6.03133e+06
19930611,533900,322100,211800,-7442,1.2315e+09,2.91456e+09,4.31253e+06
19930614,531100,298800,232300,-2286,1.23244e+09,2.89787e+09,3.40994e+06
19930615,530700,302600,228100,-4778,1.23172e+09,2.90124e+09,3.50184e+06
19930616,528700,305900,222800,15004,1.23454e+09,2.8925e+09,3.82781e+06
19930617,526500,303000,223500,626,1.23206e+09,2.89737e+09,4.1153e+06
19930618,526900,312500,214400,-60625,1.22272e+09,2.87901e+09,4.45046e+06
19930621,527200,314000,213200,-10634,1.22088e+09,2.88585e+09,4.34883e+06
19930622,527100,313800,213300,-5676,1.21806e+09,2.88758e+09,4.22926e+06
19930623,527100,305100,222000,28103,1.22015e+09,2.87772e+09,3.65884e+06
19930624,528400,304100,224300,10388,1.22079e+09,2.90396e+09,3.56393e+06
19930625,527200,315500,211700,13546,1.22145e+09,2.91064e+09,4.41615e+06
19930628,525600,328700,196900,73483,1.23414e+09,2.92071e+09,5.7972e+06
19930629,525300,344900,180400,-54100,1.22864e+09,2.90129e+09,6.70013e+06
19930630,526700,363400,163300,21431,1.22849e+09,2.92756e+09,7.94136e+06
19930701,525800,376900,148900,12249,1.22855e+09,2.91572e+09,8.64618e+06
19930702,523800,392000,131800,-4393,1.22832e+09,2.88844e+09,9.25448e+06
19930706,523700,384400,139300,5874,1.23016e+09,2.86819e+09,8.76457e+06
19930707,525100,380800,144300,-3087,1.228e+09,2.87047e+09,8.30219e+06
19930708,525400,373500,151900,38830,1.23028e+09,2.89757e+09,7.89099e+06
19930709,526300,365000,161300,19281,1.23314e+09,2.90803e+09,7.34087e+06
19930712,526400,379500,146900,38064,1.2385e+09,2.90859e+09,7.94873e+06
19930713,527300,386700,140600,15520,1.23994e+09,2.91268e+09,8.32031e+06
19930714,528300,387000,141300,28724,1.24492e+09,2.93613e+09,8.18011e+06
19930715,528200,383900,144300,22066,1.2485e+09,2.93669e+09,8.05582e+06
19930716,526600,389600,137000,-35900,1.24678e+09,2.888e+09,8.45302e+06
19930719,526700,388600,138100,19810,1.25043e+09,2.88056e+09,8.35788e+06
19930720,531900,391500,140400,828,1.24767e+09,2.9261e+09,8.0811e+06
19930721,532000,380400,151600,19817,1.25056e+09,2.93053e+09,7.60645e+06
19930722,538200,342900,195300,-18655,1.24874e+09,2.93932e+09,5.71658e+06
19930723,539600,323800,215800,-7049,1.24705e+09,2.95942e+09,5.13309e+06
19930726,539100,341600,197500,12697,1.24758e+09,2.96994e+09,5.51362e+06
19930727,540300,347400,192900,881,1.24861e+09,2.96475e+09,6.08318e+06
19930728,539800,349400,190400,27478,1.25204e+09,2.96295e+09,6.21418e+06
19930729,537600,379700,157900,48855,1.26078e+09,2.97785e+09,7.96602e+06
19930730,535900,370600,165300,-2299,1.25992e+09,2.9683e+09,7.59694e+06
19930802,535300,355200,180100,63822,1.26955e+09,2.98242e+09,7.18349e+06
19930803,533900,364400,169500,-12647,1.26522e+09,2.97415e+09,7.99585e+06
19930804,533800,369600,164200,-7971,1.26337e+09,2.97709e+09,7.87201e+06
19930805,530000,381400,148600,31364,1.26604e+09,2.95992e+09,8.22662e+06
19930806,529500,396800,132700,23531,1.26953e+09,2.96772e+09,8.83361e+06
19930809,530800,406000,124800,105705,1.2824e+09,2.99753e+09,9.63724e+06
19930810,530300,411300,119000,36849,1.28412e+09,2.98995e+09,9.9124e+06
19930811,531800,407100,124700,17103,1.27868e+09,3.01575e+09,9.98248e+06
19930812,532100,411800,120300,-36859,1.27641e+09,3.00384e+09,1.00427e+07
19930813,532700,408100,124600,42011,1.27794e+09,3.01888e+09,1.00761e+07
19930816,532100,413900,118200,36269,1.2806e+09,3.03455e+09,1.04753e+07
19930817,531700,419900,111800,13726,1.28312e+09,3.04696e+09,1.06976e+07
19930818,531200,436200,95000,23825,1.28473e+09,3.06273e+09,1.16499e+07
19930819,531100,442900,88200,32997,1.29084e+09,3.06027e+09,1.19643e+07
19930820,528700,448700,80000,-39860,1.28732e+09,3.04223e+09,1.24776e+07
19930823,528600,451900,76700,15821,1.28893e+09,3.04058e+09,1.24871e+07
19930824,528500,462300,66200,89422,1.30078e+09,3.06422e+09,1.31842e+07
19930825,529100,466000,63100,-9025,1.30037e+09,3.06128e+09,1.35462e+07
19930826,528600,457100,71500,-43129,1.29768e+09,3.04788e+09,1.30122e+07
19930827,528000,458100,69900,-45007,1.29293e+09,3.03355e+09,1.3068e+07
19930830,530000,444900,85100,40947,1.29976e+09,3.05687e+09,1.31007e+07
19930831,530300,441000,89300,33031,1.30716e+09,3.07178e+09,1.29039e+07
19930901,529500,439000,90500,-9788,1.30904e+09,3.06784e+09,1.27611e+07
19930902,529400,447000,82400,-7972,1.30455e+09,3.06325e+09,1.29785e+07
19930903,525000,447100,77900,20202,1.30882e+09,3.04799e+09,1.25997e+07
19930907,523700,436200,87500,-83425,1.2954e+09,3.01318e+09,1.17542e+07
19930908,523400,423100,100300,-94478,1.27776e+09,2.98888e+09,1.03096e+07
19930909,525800,395700,130100,42953,1.28588e+09,3.03155e+09,8.95043e+06
19930910,527300,394400,132900,85948,1.29966e+09,3.08519e+09,9.0242e+06
19930913,526000,372400,153600,64130,1.31112e+09,3.08035e+09,7.90074e+06
19930914,526300,359800,166500,-75131,1.302e+09,3.0584e+09,7.36063e+06
19930915,525000,366700,158300,65792,1.31257e+09,3.0627e+09,7.761e+06
19930916,523800,371000,152800,-19169,1.30913e+09,3.05164e+09,8.06314e+06
19930917,524500,370500,154000,-1156,1.30764e+09,3.05516e+09,8.1884e+06
19930920,524400,366300,158100,-49967,1.30229e+09,3.0265e+09,8.01329e+06
19930921,524800,343400,181400,-108746,1.28865e+09,2.99209e+09,6.48249e+06
19930922,524600,324300,200300,34664,1.29256e+09,3.01719e+09,5.55859e+06
19930923,523400,317300,206100,50889,1.30072e+09,3.03043e+09,5.08953e+06
19930924,523000,322000,201000,3580,1.30015e+09,3.03696e+09,5.19883e+06
19930927,523600,324400,199200,42036,1.30748e+09,3.06077e+09,5.42129e+06
19930928,521800,330700,191100,31043,1.30882e+09,3.0502e+09,5.86921e+06
19930929,521200,359300,161900,-8402,1.30764e+09,3.04644e+09,7.27897e+06
19930930,521000,386200,134800,-51250,1.30217e+09,3.02522e+09,8.32965e+06
19931001,519200,406500,112700,30838,1.30861e+09,3.01385e+09,9.51771e+06
19931004,519000,395900,123100,31773,1.31512e+09,3.01886e+09,8.70761e+06
19931005,519200,393400,125800,23526,1.31802e+09,3.0087e+09,8.60528e+06
19931006,518300,409900,108400,-48436,1.30505e+09,2.99973e+09,9.25998e+06
19931007,520000,397800,122200,22898,1.30965e+09,3.00597e+09,8.56515e+06
19931008,519900,387100,132800,-1476,1.30911e+09,3.01836e+09,8.33109e+06
19931011,520000,382000,138000,12334,1.31076e+09,3.0202e+09,7.96305e+06
19931012,519300,381600,137700,36863,1.31321e+09,3.02164e+09,7.73532e+06
19931013,519700,392500,127200,100834,1.32954e+09,3.02699e+09,7.9991e+06
19931014,518600,401900,116700,80273,1.33885e+09,3.03914e+09,9.12196e+06
19931015,517800,411100,106700,66770,1.34943e+09,3.05622e+09,9.62158e+06
19931018,517500,396700,120800,-2488,1.35063e+09,3.04991e+09,8.9702e+06
19931019,518900,402900,116000,-147391,1.3306e+09,3.02538e+09,9.33046e+06
19931020,518400,390600,127800,-15709,1.33108e+09,3.00618e+09,8.71487e+06
19931021,518400,377400,141000,-11027,1.33069e+09,3.0043e+09,7.73086e+06
19931022,518900,364700,154200,-47930,1.32186e+09,3.0007e+09,7.10976e+06
19931025,520600,339500,181100,19615,1.32128e+09,3.00113e+09,5.84506e+06
19931026,521800,333200,188600,3495,1.32256e+09,2.99949e+09,5.36511e+06
19931027,522500,326900,195600,15378,1.32713e+09,3.01807e+09,4.94171e+06
19931028,523100,319900,203200,4986,1.32784e+09,3.04217e+09,4.70854e+06
19931029,521500,317200,204300,47256,1.33431e+09,3.03486e+09,4.60314e+06
19931101,521700,328000,193700,21324,1.33848e+09,3.05852e+09,5.25277e+06
19931102,522300,335200,187100,9077,1.33941e+09,3.06009e+09,5.76785e+06
19931103,520300,328800,191500,-50713,1.3304e+09,2.99256e+09,5.96404e+06
19931104,522000,309600,212400,-14574,1.32514e+09,2.96275e+09,4.55622e+06
19931105,522300,292600,229700,-15982,1.32442e+09,2.96982e+09,3.00884e+06
19931108,528900,272400,256500,27389,1.32341e+09,3.00717e+09,1.88264e+06
19931109,534000,272500,261500,57811,1.3291e+09,3.03884e+09,1.72913e+06
19931110,533900,262400,271500,37760,1.33406e+09,3.06525e+09,900032
19931111,533800,263200,270600,48375,1.34296e+09,3.06908e+09,1.24465e+06
19931112,533500,262600,270900,39846,1.34915e+09,3.07553e+09,1.49605e+06
19931115,533800,283200,250600,8565,1.35118e+09,3.05497e+09,2.89277e+06
19931116,534200,292500,241700,-5018,1.35052e+09,3.06596e+09,2.7553e+06
19931117,534400,294600,239800,-45760,1.34403e+09,3.0403e+09,3.07487e+06
19931118,534700,292400,242300,10408,1.3448e+09,3.02205e+09,3.08762e+06
19931119,534300,288400,245900,3025,1.3448e+09,3.00923e+09,2.729e+06
19931122,535900,281100,254800,-17759,1.34177e+09,2.98e+09,2.01451e+06
19931123,536600,270400,266200,-47012,1.33571e+09,3.00442e+09,1.5043e+06
19931124,538300,255900,282400,-25505,1.33068e+09,3.03554e+09,492968
19931126,537900,260300,277600,22340,1.33417e+09,3.04121e+09,859123
19931129,536300,275300,261000,36955,1.34028e+09,3.02903e+09,1.04604e+06
19931130,535900,298800,237100,-10709,1.34042e+09,3.02546e+09,2.4288e+06
19931201,534800,332700,202100,45199,1.34821e+09,3.01872e+09,4.56154e+06
19931202,534200,348500,185700,6892,1.35105e+09,3.01643e+09,5.5156e+06
19931203,535500,349100,186400,49230,1.35718e+09,3.03982e+09,6.31721e+06
19931206,534500,360000,174500,16965,1.36164e+09,3.04265e+09,7.01767e+06
19931207,534400,355700,178700,22829,1.36374e+09,3.04222e+09,7.12485e+06
19931208,533800,376000,157800,-2151,1.36262e+09,3.038e+09,8.18675e+06
19931209,534300,373800,160500,-20676,1.35991e+09,3.02033e+09,8.03606e+06
19931210,538400,379000,159400,312,1.35871e+09,3.03785e+09,7.80694e+06
19931213,538100,389700,148400,693,1.35756e+09,3.04407e+09,8.28297e+06
19931214,539600,384100,155500,-25604,1.35514e+09,3.04276e+09,8.26988e+06
19931215,541400,379900,161500,-12714,1.35351e+09,3.06008e+09,7.89059e+06
19931216,536400,364600,171800,48195,1.35694e+09,3.06924e+09,7.86199e+06
19931217,537300,365100,172200,57098,1.36289e+09,3.09852e+09,7.80622e+06
19931220,537400,366900,170500,25918,1.36663e+09,3.10254e+09,7.82398e+06
19931221,537600,368400,169200,-8728,1.36478e+09,3.09121e+09,7.71162e+06
19931222,537700,371100,166600,1024,1.36503e+09,3.09867e+09,7.79914e+06
19931223,538900,375600,163300,16156,1.36813e+09,3.10994e+09,8.32886e+06
19931227,538800,380700,158100,24097,1.3746e+09,3.12441e+09,8.69102e+06
19931228,539400,379200,160200,30155,1.37908e+09,3.13204e+09,9.31206e+06
19931229,539000,391800,147200,50690,1.38698e+09,3.13772e+09,1.02883e+07
19931230,538900,398800,140100,-12944,1.38361e+09,3.13329e+09,1.05872e+07
19931231,539000,410300,128700,-4343,1.38025e+09,3.13432e+09,1.12082e+07
19940103,538800,412400,126400,-75426,1.36944e+09,3.10722e+09,1.12448e+07
19940104,538000,409800,128200,34338,1.37614e+09,3.09788e+09,1.09103e+07
19940105,538100,416900,121200,24631,1.3825e+09,3.1071e+09,1.06982e+07
19940106,537200,411900,125300,-9439,1.38196e+09,3.09739e+09,1.00524e+07
19940107,535600,403600,132000,25485,1.38221e+09,3.11089e+09,8.67068e+06
19940110,535900,399300,136600,106575,1.39796e+09,3.13395e+09,8.5451e+06
19940111,537200,395100,142100,-15156,1.39525e+09,3.1623e+09,7.98919e+06
19940112,539200,409500,129700,28529,1.3974e+09,3.17777e+09,9.03588e+06
19940113,540300,404500,135800,-29054,1.393e+09,3.17822e+09,9.15948e+06
19940114,539500,413100,126400,52655,1.40332e+09,3.18828e+09,9.68782e+06
19940117,537300,415000,122300,27966,1.41031e+09,3.16763e+09,9.51028e+06
19940118,538600,414500,124100,12258,1.41201e+09,3.17763e+09,9.17497e+06
19940119,538100,406300,131800,-52981,1.40246e+09,3.16652e+09,8.39805e+06
19940120,537900,410700,127200,-27313,1.39518e+09,3.15628e+09,8.48362e+06
19940121,537700,405700,132000,24761,1.39814e+09,3.15176e+09,8.14886e+06
19940124,537700,392600,145100,4919,1.39965e+09,3.13416e+09,7.58527e+06
19940125,538100,373200,164900,-47829,1.39015e+09,3.13129e+09,6.45315e+06
19940126,538900,366100,172800,-12412,1.38663e+09,3.1417e+09,6.2296e+06
19940127,538000,363500,174500,15506,1.38729e+09,3.15821e+09,6.48274e+06
19940128,536800,371200,165600,52066,1.39393e+09,3.1717e+09,7.24519e+06
19940131,535800,388900,146900,86793,1.40491e+09,3.18916e+09,8.65341e+06
19940201,535000,408300,126700,-55325,1.39353e+09,3.18098e+09,9.93229e+06
19940202,533600,431400,102200,50381,1.40162e+09,3.19026e+09,1.10482e+07
19940203,533400,437900,95500,12859,1.40539e+09,3.18795e+09,1.16758e+07
19940204,533000,434800,98200,-260862,1.36992e+09,3.11515e+09,1.11362e+07
19940207,534400,404900,129500,45247,1.37833e+09,3.13047e+09,9.64998e+06
19940208,537500,378400,159100,37249,1.3852e+09,3.15879e+09,7.82178e+06
19940209,536800,358000,178800,54726,1.3943e+09,3.16508e+09,6.65434e+06
19940210,538500,341900,196600,-66392,1.38375e+09,3.15803e+09,5.33484e+06
19940211,538100,341600,196500,-6215,1.38384e+09,3.15462e+09,5.31902e+06
19940214,537900,337000,200900,-2674,1.38118e+09,3.16373e+09,5.08964e+06
19940215,538000,335000,203000,49031,1.38891e+09,3.17695e+09,5.40915e+06
19940216,537400,330100,207300,52829,1.39314e+09,3.18899e+09,5.03585e+06
19940217,537800,332600,205200,-9026,1.39161e+09,3.17719e+09,5.18436e+06
19940218,537400,330800,206600,9959,1.39167e+09,3.16021e+09,4.80196e+06
19940222,535600,322800,212800,55479,1.40003e+09,3.17837e+09,4.68138e+06
19940223,535400,311100,224300,34926,1.40415e+09,3.1757e+09,4.24591e+06
19940224,535400,298500,236900,-4901,1.40194e+09,3.13364e+09,3.51122e+06
19940225,535800,283700,252100,13757,1.40268e+09,3.14992e+09,2.68499e+06
19940228,535900,283900,252000,-3607,1.40249e+09,3.16806e+09,2.80442e+06
19940301,532800,264800,268000,16009,1.40253e+09,3.12555e+09,1.93276e+06
19940302,534900,252900,282000,29628,1.40533e+09,3.1301e+09,930175
19940303,534900,283300,251600,41860,1.41454e+09,3.12681e+09,2.52438e+06
19940304,534200,298800,235400,34747,1.41951e+09,3.13533e+09,2.98483e+06
19940307,533700,309200,224500,62267,1.42883e+09,3.15154e+09,3.75246e+06
19940308,533300,309400,223900,20288,1.43212e+09,3.14698e+09,3.7328e+06
19940309,531200,321500,209700,13184,1.43288e+09,3.13502e+09,4.43335e+06
19940310,530800,331800,199000,-28615,1.42997e+09,3.11727e+09,5.13057e+06
19940311,529300,339200,190100,-24690,1.43003e+09,3.10214e+09,5.67164e+06
19940314,529400,346700,182700,23162,1.4332e+09,3.11226e+09,6.07252e+06
19940315,531800,348600,183200,24661,1.43099e+09,3.10524e+09,6.44216e+06
19940316,532300,359300,173000,24244,1.43288e+09,3.12039e+09,7.06033e+06
19940317,531700,368000,163700,38172,1.43747e+09,3.13097e+09,8.01709e+06
19940318,533800,388700,145100,-25049,1.43817e+09,3.12344e+09,9.24096e+06
19940321,533000,402900,130100,-69279,1.4245e+09,3.1013e+09,9.88713e+06
19940322,532900,387900,145000,40442,1.43166e+09,3.10864e+09,9.30363e+06
19940323,532800,393800,139000,22742,1.43707e+09,3.10985e+09,9.66742e+06
19940324,534300,385900,148400,-90022,1.42409e+09,3.0916e+09,9.25155e+06
19940325,535100,374300,160800,-65766,1.41805e+09,3.06731e+09,8.34418e+06
19940328,535600,357300,178300,-105902,1.40051e+09,3.04464e+09,6.41927e+06
19940329,540000,317300,222700,-45683,1.39445e+09,2.99828e+09,3.58566e+06
19940330,544800,244300,300500,12760,1.39638e+09,2.99623e+09,-688018
19940331,550200,161100,389100,-48716,1.39408e+09,3.03049e+09,-5.80181e+06
19940404,555200,103100,452100,234080,1.42481e+09,3.00028e+09,-9.42312e+06
19940405,556000,81800,474200,-269370,1.3837e+09,3.06698e+09,-1.09608e+07
19940406,556300,80000,476300,11037,1.3839e+09,3.07511e+09,-1.09259e+07
19940407,558000,81600,476400,-69631,1.37562e+09,3.11002e+09,-1.07379e+07
19940408,557800,82200,475600,120798,1.39185e+09,3.08398e+09,-1.03414e+07
19940411,557500,117100,440400,-5104,1.38535e+09,3.07482e+09,-7.77754e+06
19940412,556700,143000,413700,44381,1.39105e+09,3.05045e+09,-6.65127e+06
19940413,557800,153000,404800,54409,1.39786e+09,3.03116e+09,-6.09877e+06
19940414,557400,153800,403600,-2552,1.39809e+09,3.0287e+09,-6.21406e+06
19940415,561100,164200,396900,27686,1.40499e+09,3.05386e+09,-5.38897e+06
19940418,560000,178400,381600,61649,1.41656e+09,3.02344e+09,-4.86502e+06
19940419,560400,193200,367200,172506,1.43892e+09,2.97748e+09,-4.05999e+06
19940420,560900,202500,358400,89814,1.45035e+09,2.95852e+09,-3.48733e+06
19940421,560500,225500,335000,-42846,1.44824e+09,3.00399e+09,-2.16313e+06
19940422,560300,242500,317800,-48077,1.44228e+09,3.00689e+09,-1.37492e+06
19940425,560000,269600,290400,-18699,1.44191e+09,3.03379e+09,174484
19940426,560600,294700,265900,-28449,1.43811e+09,3.03622e+09,1.36921e+06
19940428,560700,324300,236400,-42341,1.43247e+09,3.02694e+09,2.96422e+06
19940429,560700,361900,198800,34416,1.43701e+09,3.04801e+09,5.43023e+06
19940502,561600,370700,190900,47702,1.44309e+09,3.06469e+09,6.30546e+06
19940503,562400,388800,173600,-20629,1.44116e+09,3.06621e+09,7.39881e+06
19940504,566100,407600,158500,-659,1.44038e+09,3.09021e+09,8.28431e+06
19940505,566200,419000,147200,-4730,1.43933e+09,3.09162e+09,9.06167e+06
19940506,567700,407800,159900,-53157,1.43229e+09,3.06457e+09,8.57687e+06
19940509,570200,398800,171400,-85952,1.42221e+09,3.04508e+09,8.04859e+06
19940510,574500,371100,203400,31638,1.42796e+09,3.07795e+09,6.70749e+06
19940511,578900,351000,227900,-2886,1.42768e+09,3.06568e+09,5.19432e+06
19940512,581400,322800,258600,38076,1.4337e+09,3.08468e+09,3.37346e+06
19940513,582000,322500,259500,11720,1.43537e+09,3.08833e+09,2.93333e+06
19940516,581600,320800,260800,-12714,1.43449e+09,3.04768e+09,2.75131e+06
19940517,581700,310600,271100,-4496,1.42952e+09,3.07175e+09,2.04331e+06
19940518,582900,330700,252200,-35705,1.42443e+09,3.11606e+09,3.45208e+06
19940519,585300,324400,260900,17240,1.42607e+09,3.15633e+09,3.53768e+06
19940520,585700,342500,243200,-651,1.42758e+09,3.14446e+09,4.77968e+06
19940523,585500,380600,204900,-36564,1.42193e+09,3.11765e+09,7.02855e+06
19940524,585500,385400,200100,15155,1.42198e+09,3.12887e+09,7.60961e+06
19940525,587200,389900,197300,21469,1.42611e+09,3.147e+09,8.45868e+06
19940526,589800,387300,202500,17935,1.42835e+09,3.16946e+09,8.40863e+06
19940527,588400,409700,178700,10597,1.42921e+09,3.16339e+09,9.47856e+06
19940531,588500,413400,175100,142029,1.4607e+09,3.16645e+09,9.76903e+06
19940601,588900,426800,162100,35722,1.46824e+09,3.18511e+09,1.02244e+07
19940602,588500,442900,145600,58099,1.47633e+09,3.19367e+09,1.06998e+07
19940603,586900,457700,129200,68947,1.487e+09,3.20067e+09,1.16451e+07
19940606,587500,466300,121200,15528,1.48886e+09,3.20588e+09,1.19766e+07
19940607,588000,483200,104800,-76053,1.48142e+09,3.17663e+09,1.2572e+07
19940608,589100,495000,94100,-53804,1.47325e+09,3.16858e+09,1.29363e+07
19940609,590400,487400,103000,-24028,1.47021e+09,3.16901e+09,1.24462e+07
19940610,591700,479600,112100,41651,1.47547e+09,3.18769e+09,1.19093e+07
19940613,593000,464800,128200,-41976,1.46907e+09,3.17196e+09,1.08038e+07
19940614,593800,459600,134200,39676,1.47242e+09,3.20143e+09,1.05319e+07
19940615,594000,463900,130100,-18720,1.46889e+09,3.19383e+09,1.02776e+07
19940616,594600,467300,127300,-2483,1.4654e+09,3.19514e+09,1.11938e+07
19940617,595900,467100,128800,-69026,1.4554e+09,3.18146e+09,1.12619e+07
19940620,596100,461100,135000,-100431,1.44105e+09,3.15005e+09,1.06928e+07
19940621,598600,423500,175100,-53848,1.43589e+09,3.13075e+09,8.38657e+06
19940622,598700,410000,188700,23132,1.43888e+09,3.14332e+09,7.67891e+06
19940623,601500,351300,250200,63872,1.44729e+09,3.12602e+09,3.80176e+06
19940624,603900,301400,302500,-30650,1.44381e+09,3.10449e+09,667956
19940627,605100,268600,336500,-41317,1.44221e+09,3.12458e+09,-1.25823e+06
19940628,605600,245600,360000,-13300,1.43693e+09,3.12458e+09,-2.36064e+06
19940629,606700,224200,382500,3976,1.43627e+09,3.1397e+09,-3.71664e+06
19940630,606900,195000,411900,52648,1.44362e+09,3.12473e+09,-5.07015e+06
19940701,605400,210800,394600,-20104,1.43996e+09,3.12911e+09,-4.28738e+06
19940705,608000,233200,374800,5257,1.43841e+09,3.15448e+09,-3.28812e+06
19940706,607600,251300,356300,-35654,1.43224e+09,3.14771e+09,-2.20921e+06
19940707,606800,266100,340700,7915,1.4289e+09,3.15475e+09,-1.36916e+06
19940708,604900,306700,298200,22892,1.43339e+09,3.15007e+09,351189
19940711,611100,327600,283500,37022,1.43939e+09,3.19136e+09,1.62366e+06
19940712,612100,349700,262400,13742,1.44042e+09,3.2053e+09,2.97877e+06
19940713,613400,381800,231600,27422,1.44725e+09,3.2301e+09,4.27521e+06
19940714,612200,408900,203300,73219,1.45902e+09,3.26158e+09,5.77408e+06
19940715,609600,437100,172500,-30555,1.45268e+09,3.24376e+09,7.73695e+06
19940718,608100,461900,146200,-13808,1.4484e+09,3.23714e+09,9.37551e+06
19940719,608000,490900,117100,-5041,1.44706e+09,3.22743e+09,1.06464e+07
19940720,607900,493300,114600,-82736,1.4388e+09,3.20558e+09,1.05425e+07
19940721,608000,489100,118900,5594,1.44385e+09,3.201e+09,1.0191e+07
19940722,608600,489400,119200,64571,1.45222e+09,3.20743e+09,1.01064e+07
19940725,608800,480700,128100,40483,1.45822e+09,3.2147e+09,9.30935e+06
19940726,613300,477700,135600,2068,1.4611e+09,3.21892e+09,8.59903e+06
19940727,614900,463800,151100,-7602,1.46091e+09,3.21868e+09,7.67484e+06
19940728,614200,466300,147900,16183,1.46074e+09,3.22271e+09,7.91321e+06
19940729,614500,466400,148100,53154,1.46794e+09,3.25282e+09,8.17638e+06
19940801,621000,436800,184200,50559,1.47644e+09,3.30923e+09,8.24471e+06
19940802,620000,451000,169000,12507,1.47952e+09,3.30403e+09,9.09707e+06
19940803,619000,456800,162200,-8129,1.47631e+09,3.30135e+09,9.55248e+06
19940804,619000,465500,153500,-42743,1.47137e+09,3.28631e+09,1.01478e+07
19940805,620600,455500,165100,-5021,1.47071e+09,3.2843e+09,9.68095e+06
19940808,620000,444900,175100,50339,1.47861e+09,3.28901e+09,9.22242e+06
19940809,619800,424700,195100,46451,1.48281e+09,3.298e+09,8.64845e+06
19940810,619600,425100,194500,95881,1.49695e+09,3.32637e+09,8.71082e+06
19940811,619200,426100,193100,-26776,1.49209e+09,3.31761e+09,8.55434e+06
19940812,617600,450400,167200,14352,1.49555e+09,3.33009e+09,8.8914e+06
19940815,618000,453100,164900,-2477,1.49574e+09,3.33108e+09,8.97762e+06
19940816,616900,472800,144100,107415,1.50926e+09,3.35957e+09,9.4613e+06
19940817,613000,471000,142000,13881,1.51136e+09,3.32734e+09,1.00734e+07
19940818,612900,487600,125300,-35940,1.50543e+09,3.31782e+09,1.10364e+07
19940819,611900,484600,127300,26592,1.50743e+09,3.32042e+09,1.05782e+07
19940822,611800,482500,129300,-11388,1.50802e+09,3.3102e+09,1.04557e+07
19940823,611600,482100,129500,65305,1.51804e+09,3.32211e+09,1.02585e+07
19940824,611200,482600,128600,50724,1.52559e+09,3.34131e+09,1.05408e+07
19940825,610700,483100,127600,31860,1.52958e+09,3.34456e+09,1.0913e+07
19940826,610300,500900,109400,135965,1.5515e+09,3.37942e+09,1.19971e+07
19940829,609100,528700,80400,-19383,1.55197e+09,3.36812e+09,1.36595e+07
19940830,607800,539700,68100,57474,1.56042e+09,3.37862e+09,1.46605e+07
19940831,606900,544400,62500,-46508,1.54982e+09,3.36647e+09,1.49464e+07
19940901,606300,546500,59800,-96417,1.53684e+09,3.34378e+09,1.46964e+07
19940902,608500,549900,58600,-109101,1.52419e+09,3.32519e+09,1.47872e+07
19940906,608400,551200,57200,-20953,1.52012e+09,3.31443e+09,1.45193e+07
19940907,607300,533100,74200,17367,1.52449e+09,3.30862e+09,1.39002e+07
19940908,607300,512900,94400,83495,1.5353e+09,3.32528e+09,1.30144e+07
19940909,608000,489600,118400,-102627,1.51802e+09,3.2974e+09,1.1359e+07
19940912,608800,478000,130800,-49217,1.51073e+09,3.28581e+09,1.06351e+07
19940913,609200,459200,150000,-13583,1.50567e+09,3.29214e+09,9.10656e+06
19940914,608600,469700,138900,31596,1.51055e+09,3.29672e+09,9.2513e+06
19940915,606300,460000,146300,97897,1.52533e+09,3.31601e+09,8.83686e+06
19940916,605700,443300,162400,-33459,1.51921e+09,3.29674e+09,7.81932e+06
19940919,605000,447300,157700,16493,1.5208e+09,3.29034e+09,8.20708e+06
19940920,610000,422600,187400,-77989,1.50944e+09,3.28576e+09,6.39678e+06
19940921,613400,393300,220100,-44105,1.50425e+09,3.28788e+09,5.3969e+06
19940922,614600,346200,268400,45586,1.51142e+09,3.28161e+09,2.32042e+06
19940923,615800,306300,309500,23745,1.51354e+09,3.27791e+09,-271622
19940926,615200,293500,321700,-2833,1.51531e+09,3.27943e+09,-1.25175e+06
19940927,615300,282500,332800,23718,1.5175e+09,3.28416e+09,-1.49176e+06
19940928,616400,291400,325000,-29016,1.5128e+09,3.31353e+09,-763413
19940929,616000,308100,307900,-15370,1.50988e+09,3.30308e+09,184938
19940930,614900,332800,282100,19547,1.51389e+09,3.28504e+09,1.76016e+06
19941003,614800,337900,276900,-35681,1.51239e+09,3.26527e+09,2.33617e+06
19941004,614500,330300,284200,-17528,1.50832e+09,3.21323e+09,2.19306e+06
19941005,615100,302900,312200,-3893,1.50783e+09,3.2052e+09,503186
19941006,615400,283000,332400,5971,1.50698e+09,3.19579e+09,-546713
19941007,615100,279400,335700,2780,1.50778e+09,3.21553e+09,-314813
19941010,613700,283500,330200,-6402,1.50926e+09,3.23987e+09,-481516
19941011,612800,315900,296900,-4792,1.50909e+09,3.28163e+09,1.17845e+06
19941012,608300,360500,247800,18692,1.51187e+09,3.25323e+09,4.16518e+06
19941013,605700,396600,209100,12353,1.51292e+09,3.24848e+09,6.82643e+06
19941014,604200,412100,192100,63207,1.52374e+09,3.24639e+09,8.98213e+06
19941017,604100,434500,169600,3337,1.52299e+09,3.24412e+09,1.01622e+07
19941018,604400,454200,150200,-17786,1.52258e+09,3.2371e+09,1.13558e+07
19941019,604500,482300,122200,57838,1.5325e+09,3.24909e+09,1.16337e+07
19941020,604800,479100,125700,-51347,1.523e+09,3.23356e+09,1.15552e+07
19941021,605500,472300,133200,-23079,1.51911e+09,3.22543e+09,1.11727e+07
19941024,607600,467200,140400,-68953,1.50889e+09,3.21049e+09,1.08627e+07
19941025,608000,462200,145800,3983,1.50924e+09,3.20914e+09,1.05142e+07
19941026,609000,437000,172000,57262,1.51809e+09,3.2222e+09,9.01898e+06
19941027,610000,411000,199000,81274,1.53245e+09,3.24604e+09,7.32445e+06
19941028,609300,407200,202100,131386,1.55456e+09,3.29017e+09,7.3293e+06
19941031,608600,410100,198500,-27752,1.54659e+09,3.2827e+09,7.75023e+06
19941101,608800,412900,195900,-78371,1.53169e+09,3.26179e+09,7.92188e+06
19941102,609200,419400,189800,-35663,1.52594e+09,3.25506e+09,8.40261e+06
19941103,609800,419700,190100,46832,1.53139e+09,3.26688e+09,8.62798e+06
19941104,611800,410600,201200,-90694,1.51484e+09,3.25498e+09,7.3726e+06
19941107,610900,391100,219800,18822,1.51772e+09,3.25319e+09,6.53321e+06
19941108,610900,393800,217100,42740,1.52443e+09,3.26496e+09,6.70097e+06
19941109,610500,390100,220400,-43503,1.51651e+09,3.25302e+09,6.2822e+06
19941110,611300,372100,239200,-7024,1.51473e+09,3.24871e+09,5.55558e+06
19941111,612500,366600,245900,-16891,1.51131e+09,3.23907e+09,5.29774e+06
19941114,612100,372200,239900,97816,1.52555e+09,3.26338e+09,5.96436e+06
19941115,613800,357900,255900,-15752,1.52227e+09,3.27193e+09,5.82511e+06
19941116,613600,348900,264700,26755,1.52646e+09,3.27339e+09,5.51269e+06
19941117,613700,349700,264000,1651,1.52956e+09,3.25823e+09,5.38642e+06
19941118,614100,354500,259600,1804,1.53028e+09,3.24439e+09,5.13205e+06
19941121,615400,341500,273900,-32692,1.52318e+09,3.23006e+09,4.02538e+06
19941122,619300,300000,319300,-6155,1.52333e+09,3.18586e+09,698985
19941123,622200,274400,347800,-13959,1.51937e+09,3.19401e+09,-1.17746e+06
19941125,622300,252300,370000,-54607,1.51383e+09,3.19854e+09,-2.65836e+06
19941128,626500,244800,381700,29806,1.5169e+09,3.23831e+09,-3.40536e+06
19941129,626400,237200,389200,-1909,1.51638e+09,3.25554e+09,-4.0217e+06
19941130,625700,239900,385800,-30666,1.51089e+09,3.24616e+09,-3.83228e+06
19941201,625600,243600,382000,12754,1.51023e+09,3.21244e+09,-3.67919e+06
19941202,625100,254800,370300,-3587,1.51041e+09,3.23271e+09,-2.88317e+06
19941205,624700,299100,325600,16756,1.51455e+09,3.23211e+09,-1.94444e+06
19941206,627500,304800,322700,25871,1.51619e+09,3.23735e+09,-1.61073e+06
19941207,629700,305600,324100,31046,1.51851e+09,3.22794e+09,-1.06039e+06
19941208,635400,267500,367900,63234,1.52533e+09,3.20305e+09,-903733
19941209,637100,253200,383900,7890,1.53014e+09,3.21714e+09,-1.16703e+06
19941212,638000,231000,407000,-9282,1.5265e+09,3.2377e+09,-2.13216e+06
19941213,642000,207700,434300,-14327,1.52476e+09,3.27174e+09,-3.39755e+06
19941214,646400,210900,435500,-37503,1.51709e+09,3.35171e+09,-2.92997e+06
19941215,645900,256900,389000,20628,1.52024e+09,3.35905e+09,-184639
19941216,644900,307300,337600,39407,1.5271e+09,3.36617e+09,2.99404e+06
19941219,643600,355700,287900,7623,1.52862e+09,3.3591e+09,5.92643e+06
19941220,643200,393500,249700,9731,1.53135e+09,3.35515e+09,8.54076e+06
19941221,642200,411600,230600,3499,1.53144e+09,3.37166e+09,9.32334e+06
19941222,643600,407800,235800,8980,1.52996e+09,3.38051e+09,9.09391e+06
19941223,643300,421100,222200,17683,1.53447e+09,3.3827e+09,9.70555e+06
19941227,643600,429800,213800,91604,1.54773e+09,3.39669e+09,1.01218e+07
19941228,643400,441400,202000,-25215,1.54612e+09,3.37977e+09,1.03744e+07
19941229,642700,444500,198200,7925,1.54578e+09,3.39287e+09,1.04892e+07
19941230,642800,442400,200400,-13344,1.54382e+09,3.38386e+09,1.03295e+07
19950103,642500,462900,179600,-49116,1.53413e+09,3.36656e+09,1.09667e+07
19950104,642100,463600,178500,6876,1.53987e+09,3.37181e+09,1.11681e+07
19950105,644700,502500,142200,-11534,1.5363e+09,3.38144e+09,1.15265e+07
19950106,643500,504200,139300,58964,1.54721e+09,3.38171e+09,1.1587e+07
19950109,641300,522000,119300,13349,1.54623e+09,3.37881e+09,1.16162e+07
19950110,642500,503400,139100,33319,1.5499e+09,3.39433e+09,1.06908e+07
19950111,644800,495500,149300,-897,1.54672e+09,3.41003e+09,1.03989e+07
19950112,644700,496300,148400,22120,1.54811e+09,3.41929e+09,1.05417e+07
19950113,644000,495000,149000,76497,1.55744e+09,3.43436e+09,1.06241e+07
19950116,642600,491300,151300,97938,1.57533e+09,3.45815e+09,1.05509e+07
19950117,642000,503700,138300,33144,1.57918e+09,3.47508e+09,1.12955e+07
19950118,642200,508900,133300,-22280,1.57553e+09,3.46634e+09,1.16452e+07
19950119,642000,531800,110200,-48779,1.5666e+09,3.45544e+09,1.2378e+07
19950120,643600,527700,115900,-53101,1.55707e+09,3.4508e+09,1.22376e+07
19950123,644600,517200,127400,-31110,1.54917e+09,3.44315e+09,1.17103e+07
19950124,644900,503000,141900,64939,1.55715e+09,3.44696e+09,1.11876e+07
19950125,645500,491400,154100,29211,1.56126e+09,3.46208e+09,1.05019e+07
19950126,645400,478100,167300,-2273,1.56082e+09,3.46232e+09,9.52479e+06
19950127,645000,485200,159800,45669,1.56695e+09,3.47246e+09,9.80464e+06
19950130,645000,476200,168800,-8169,1.56519e+09,3.45668e+09,9.0734e+06
19950131,644000,474700,169300,39353,1.5694e+09,3.46166e+09,8.7202e+06
19950201,645600,474200,171400,848,1.56863e+09,3.47812e+09,8.71272e+06
19950202,646400,477900,168500,34566,1.57278e+09,3.49942e+09,8.6163e+06
19950203,645900,473800,172100,128395,1.59219e+09,3.54065e+09,8.25526e+06
19950206,645900,475100,170800,61472,1.60178e+09,3.56307e+09,8.79178e+06
19950207,644700,507100,137600,-7394,1.60252e+09,3.55567e+09,1.08858e+07
19950208,643500,522800,120700,13354,1.60271e+09,3.55445e+09,1.24481e+07
19950209,641200,525100,116100,-27079,1.60074e+09,3.54565e+09,1.27208e+07
19950210,640100,529200,110900,41735,1.60675e+09,3.55049e+09,1.3224e+07
19950213,639600,544900,94700,17203,1.60917e+09,3.54951e+09,1.37134e+07
19950214,638500,558400,80100,40254,1.61608e+09,3.55081e+09,1.46863e+07
19950215,638100,569900,68200,78174,1.62791e+09,3.56685e+09,1.52361e+07
19950216,637100,575300,61800,-11626,1.6261e+09,3.55895e+09,1.51911e+07
19950217,636800,593600,43200,-67129,1.61589e+09,3.54029e+09,1.55824e+07
19950221,636400,602000,34400,-4565,1.61511e+09,3.53894e+09,1.60555e+07
19950222,636400,596900,39500,65083,1.62691e+09,3.55437e+09,1.58845e+07
19950223,636600,584200,52400,56799,1.63663e+09,3.56547e+09,1.52213e+07
19950224,632700,554300,78400,27153,1.64075e+09,3.55716e+09,1.42431e+07
19950227,633000,548300,84700,-90284,1.62848e+09,3.53337e+09,1.3948e+07
19950228,632600,547400,85200,119259,1.64701e+09,3.56233e+09,1.39287e+07
19950301,632000,540800,91200,-39230,1.64012e+09,3.56075e+09,1.37454e+07
19950302,632700,521200,111500,3826,1.63736e+09,3.56974e+09,1.31403e+07
19950303,633200,502500,130700,29101,1.64422e+09,3.5714e+09,1.20917e+07
19950306,632900,495400,137500,10766,1.64576e+09,3.5738e+09,1.13897e+07
19950307,633500,480400,153100,-82089,1.63209e+09,3.54905e+09,1.04762e+07
19950308,634000,467800,166200,28655,1.63989e+09,3.55136e+09,1.00331e+07
19950309,634600,436400,198200,20079,1.64068e+09,3.55603e+09,8.73878e+06
19950310,632900,423500,209400,64900,1.64879e+09,3.58567e+09,8.27967e+06
19950313,632800,422200,210600,30048,1.65459e+09,3.59753e+09,8.19532e+06
19950314,631700,429600,202100,65057,1.66704e+09,3.61213e+09,8.23533e+06
19950315,623600,415300,208300,-24635,1.66194e+09,3.53014e+09,8.77831e+06
19950316,623100,439400,183700,25083,1.66371e+09,3.53168e+09,9.76466e+06
19950317,622700,479100,143600,-2479,1.66273e+09,3.53163e+09,1.1483e+07
19950320,619000,475400,143600,26509,1.66685e+09,3.50618e+09,1.14673e+07
19950321,618000,466500,151500,-19873,1.66362e+09,3.49251e+09,1.10194e+07
19950322,618300,475800,142500,-5219,1.66124e+09,3.49621e+09,1.11316e+07
19950323,618900,468100,150800,30277,1.66618e+09,3.50975e+09,1.08126e+07
19950324,617800,465400,152400,110752,1.6881e+09,3.53196e+09,1.09044e+07
19950327,616500,473800,142700,74024,1.69919e+09,3.54065e+09,1.12952e+07
19950328,615600,496300,119300,31394,1.70415e+09,3.54375e+09,1.21588e+07
19950329,614700,504500,110200,-21309,1.69843e+09,3.52927e+09,1.29897e+07
19950330,613800,506200,107600,-23495,1.69387e+09,3.52416e+09,1.37407e+07
19950331,612300,501400,110900,-14520,1.69114e+09,3.50608e+09,1.34863e+07
19950403,611100,494500,116600,11638,1.69235e+09,3.51016e+09,1.33444e+07
19950404,610300,488300,122000,73719,1.7048e+09,3.51139e+09,1.31518e+07
19950405,611700,494800,116900,20907,1.70849e+09,3.53345e+09,1.31855e+07
19950406,611100,495700,115400,960,1.70728e+09,3.52635e+09,1.3045e+07
19950407,609600,487500,122100,-9500,1.70428e+09,3.52749e+09,1.23939e+07
19950410,609300,485900,123400,12935,1.70738e+09,3.53131e+09,1.23702e+07
19950411,609500,485300,124200,-28942,1.70346e+09,3.52708e+09,1.22397e+07
19950412,608700,488600,120100,58529,1.71262e+09,3.5394e+09,1.25258e+07
19950413,606900,474000,132900,30021,1.71826e+09,3.54443e+09,1.25239e+07
19950417,606600,464100,142500,-105453,1.70213e+09,3.50981e+09,1.17955e+07
19950418,606700,452600,154100,-57340,1.69156e+09,3.49679e+09,1.09002e+07
19950419,608200,438300,169900,19021,1.69481e+09,3.48882e+09,1.0323e+07
19950420,608700,428100,180600,16567,1.69439e+09,3.50418e+09,9.04104e+06
19950421,607600,398900,208700,44130,1.69829e+09,3.51318e+09,7.74848e+06
19950424,606600,394500,212100,47731,1.70334e+09,3.53546e+09,7.3941e+06
19950425,606000,388500,217500,9803,1.70683e+09,3.52473e+09,7.02933e+06
19950426,605100,408600,196500,31940,1.70837e+09,3.52347e+09,8.24683e+06
19950427,603700,428900,174800,-22126,1.7063e+09,3.52033e+09,9.28022e+06
19950428,602600,432100,170500,-9588,1.70923e+09,3.49396e+09,9.3743e+06
19950501,603000,429200,173800,26150,1.71047e+09,3.49161e+09,9.3852e+06
19950502,604600,434800,169800,19141,1.71442e+09,3.51402e+09,9.44687e+06
19950503,603100,451600,151500,137164,1.73356e+09,3.53886e+09,1.04787e+07
19950504,602400,459400,143000,33498,1.73694e+09,3.52675e+09,1.04854e+07
19950505,600100,462600,137500,23850,1.73991e+09,3.49706e+09,1.06997e+07
19950508,598700,472000,126700,106945,1.7582e+09,3.5106e+09,1.1245e+07
19950509,597600,473800,123800,44507,1.76604e+09,3.50634e+09,1.11151e+07
19950510,596500,482600,113900,4705,1.76717e+09,3.50466e+09,1.12159e+07
19950511,595500,484800,110700,28255,1.76962e+09,3.51432e+09,1.14584e+07
19950512,595100,506800,88300,38826,1.77653e+09,3.5213e+09,1.26765e+07
19950515,595000,510300,84700,65701,1.78671e+09,3.54457e+09,1.2832e+07
19950516,594500,508600,85900,55325,1.79712e+09,3.55357e+09,1.31415e+07
19950517,594900,510500,84400,-15430,1.79412e+09,3.55059e+09,1.33756e+07
19950518,593900,510400,83500,-193950,1.76415e+09,3.50349e+09,1.31493e+07
19950519,594400,490200,104200,-26934,1.76103e+09,3.49922e+09,1.20519e+07
19950522,594500,482300,112200,84558,1.77476e+09,3.52387e+09,1.15443e+07
19950523,593400,463600,129800,51903,1.78324e+09,3.5218e+09,1.11207e+07
19950524,593800,452900,140900,-11635,1.77972e+09,3.52087e+09,1.04959e+07
19950525,593500,456500,137000,-23277,1.77768e+09,3.50462e+09,1.03654e+07
19950526,592200,452600,139600,-141809,1.76032e+09,3.45549e+09,1.03398e+07
19950530,590800,440100,150700,9426,1.76237e+09,3.42747e+09,9.83823e+06
19950531,591900,436200,155700,130029,1.77963e+09,3.47043e+09,9.62092e+06
19950601,592000,429600,162400,40955,1.78707e+09,3.4802e+09,9.31498e+06
19950602,592100,435600,156500,17179,1.79034e+09,3.47856e+09,9.61058e+06
19950605,591100,447400,143700,90292,1.80161e+09,3.49977e+09,1.0266e+07
19950606,595100,469200,125900,16799,1.80071e+09,3.54119e+09,1.14142e+07
19950607,593900,482100,111800,-76610,1.78869e+09,3.52851e+09,1.2059e+07
19950608,592900,490600,102300,-40595,1.78161e+09,3.52939e+09,1.22389e+07
19950609,590500,494200,96300,-94079,1.76675e+09,3.49892e+09,1.26279e+07
19950612,589500,486000,103500,77035,1.78016e+09,3.50568e+09,1.25518e+07
19950613,589100,482100,107000,113041,1.79785e+09,3.53196e+09,1.27466e+07
19950614,588700,491500,97200,7523,1.79891e+09,3.53351e+09,1.32208e+07
19950615,588000,496400,91600,38015,1.80445e+09,3.5381e+09,1.34821e+07
19950616,587000,504400,82600,47746,1.81291e+09,3.5466e+09,1.37211e+07
19950619,585800,515600,70200,69373,1.82358e+09,3.55942e+09,1.43443e+07
19950620,581900,511500,70400,22256,1.82704e+09,3.53279e+09,1.45144e+07
19950621,581300,523100,58200,-19435,1.82366e+09,3.51699e+09,1.49671e+07
19950622,580800,523600,57200,177498,1.84767e+09,3.55869e+09,1.51198e+07
19950623,580600,514300,66300,-59053,1.8404e+09,3.54517e+09,1.46865e+07
19950626,580600,488300,92300,-140125,1.81773e+09,3.51554e+09,1.35677e+07
19950627,578900,475700,103200,-81446,1.80542e+09,3.49393e+09,1.26249e+07
19950628,578700,461800,116900,36259,1.80967e+09,3.50179e+09,1.20495e+07
19950629,578800,449400,129400,18506,1.81045e+09,3.50995e+09,1.14644e+07
19950630,578700,448800,129900,20563,1.81415e+09,3.51616e+09,1.10109e+07
19950703,578400,440500,137900,-17736,1.814e+09,3.50285e+09,1.04093e+07
19950705,578200,444000,134200,54451,1.81936e+09,3.51278e+09,1.05914e+07
19950706,577600,456100,121500,175519,1.84656e+09,3.55257e+09,1.16033e+07
19950707,575600,467800,107800,133212,1.86553e+09,3.57741e+09,1.25298e+07
19950710,571300,472600,98700,35346,1.87094e+09,3.57314e+09,1.26758e+07
19950711,569800,471900,97900,-64263,1.86575e+09,3.54651e+09,1.25972e+07
19950712,569400,469100,100300,125983,1.88488e+09,3.5786e+09,1.24711e+07
19950713,569100,465400,103700,17086,1.88503e+09,3.58357e+09,1.22474e+07
19950714,568100,460200,107900,6806,1.88271e+09,3.58333e+09,1.18676e+07
19950717,568600,457800,110800,54080,1.89012e+09,3.59905e+09,1.17783e+07
19950718,568100,461500,106600,-112775,1.87222e+09,3.56451e+09,1.21355e+07
19950719,568300,450700,117600,-197796,1.84233e+09,3.50128e+09,1.12019e+07
19950720,569500,439900,129600,69210,1.85087e+09,3.52856e+09,1.0823e+07
19950721,569300,435000,134300,25180,1.85336e+09,3.53154e+09,1.03672e+07
19950724,569000,421700,147300,72685,1.86321e+09,3.56697e+09,9.26135e+06
19950725,567700,418300,149400,84063,1.87614e+09,3.59299e+09,9.06971e+06
19950726,564800,417400,147400,44347,1.88114e+09,3.60505e+09,8.94215e+06
19950727,562000,439300,122700,108458,1.89591e+09,3.61932e+09,1.0174e+07
19950728,561300,458700,102600,-40648,1.88874e+09,3.60693e+09,1.13832e+07
19950731,559400,465400,94000,-1395,1.88876e+09,3.59195e+09,1.20567e+07
19950801,558600,471700,86900,-38474,1.88255e+09,3.57629e+09,1.24851e+07
19950802,559000,465300,93700,-22876,1.88017e+09,3.5639e+09,1.23513e+07
19950803,558400,438900,119500,-20459,1.87837e+09,3.55616e+09,1.06406e+07
19950804,560300,432700,127600,17617,1.87946e+09,3.58968e+09,1.00957e+07
19950807,559400,438200,121200,49142,1.88928e+09,3.5845e+09,9.90026e+06
19950808,559000,435400,123600,3692,1.88746e+09,3.5858e+09,9.7688e+06
19950809,556400,417800,138600,10070,1.88661e+09,3.57292e+09,9.1232e+06
19950810,550500,415100,135400,-1925,1.88712e+09,3.49931e+09,9.75532e+06
19950811,550500,414700,135800,-17318,1.88599e+09,3.48961e+09,9.74644e+06
19950814,550700,419900,130800,24204,1.8959e+09,3.48091e+09,1.01136e+07
19950815,551200,407600,143600,18401,1.89575e+09,3.48152e+09,9.3234e+06
19950816,552000,401600,150400,11264,1.89118e+09,3.50277e+09,8.86412e+06
19950817,552200,391200,161000,-20044,1.88697e+09,3.50443e+09,8.76133e+06
19950818,551700,412700,139000,-7077,1.8859e+09,3.50255e+09,9.72768e+06
19950821,551100,416100,135000,-62928,1.88053e+09,3.44878e+09,9.64528e+06
19950822,550800,426600,124200,-22609,1.87798e+09,3.44386e+09,9.884e+06
19950823,550300,432200,118100,16596,1.87919e+09,3.4376e+09,1.00082e+07
19950824,550200,436100,114100,-9976,1.87978e+09,3.42949e+09,1.0219e+07
19950825,549600,446900,102700,43110,1.88477e+09,3.4357e+09,1.05992e+07
19950828,548000,441100,106900,-14121,1.88191e+09,3.4214e+09,1.04147e+07
19950829,548000,433200,114800,3208,1.88382e+09,3.41989e+09,9.82742e+06
19950830,548100,422200,125900,52425,1.8927e+09,3.43087e+09,9.20502e+06
19950831,548100,416300,131800,29530,1.89877e+09,3.44962e+09,9.31041e+06
19950901,546700,417300,129400,81162,1.90986e+09,3.46606e+09,9.68691e+06
19950905,547500,426300,121200,13288,1.90059e+09,3.5214e+09,1.05835e+07
19950906,546500,455100,91400,56509,1.90992e+09,3.52904e+09,1.22342e+07
19950907,545600,465300,80300,-24998,1.90482e+09,3.52898e+09,1.31825e+07
19950908,543600,468700,74900,78895,1.91515e+09,3.53697e+09,1.34536e+07
19950911,542400,480200,62200,63291,1.92451e+09,3.53837e+09,1.44146e+07
19950912,542100,483300,58800,35656,1.93055e+09,3.54266e+09,1.4802e+07
19950913,541400,484200,57200,19786,1.93438e+09,3.54564e+09,1.51764e+07
19950914,541400,481400,60000,113383,1.95533e+09,3.5557e+09,1.52722e+07
19950915,581700,516500,65200,-38614,1.9519e+09,3.7285e+09,1.50448e+07
19950918,580200,515900,64300,-131302,1.92529e+09,3.70354e+09,1.49025e+07
19950919,579600,515500,64100,47038,1.93479e+09,3.71991e+09,1.46721e+07
19950920,581700,501800,79900,2118,1.93524e+09,3.74107e+09,1.39504e+07
19950921,581800,503000,78800,-59968,1.92544e+09,3.7181e+09,1.4023e+07
19950922,582300,488800,93500,-37435,1.91841e+09,3.71601e+09,1.31596e+07
19950925,582700,488800,93900,-591,1.91687e+09,3.71602e+09,1.27331e+07
19950926,584600,460300,124300,-12865,1.91656e+09,3.71987e+09,1.12059e+07
19950927,586400,412300,174100,1366,1.91645e+09,3.71761e+09,8.09636e+06
19950928,598100,352200,245900,53415,1.92668e+09,3.80969e+09,6.8998e+06
19950929,598800,329000,269800,15340,1.93123e+09,3.80157e+09,5.71057e+06
19951002,598300,320000,278300,6623,1.93308e+09,3.75129e+09,4.98343e+06
19951003,597700,306500,291200,66307,1.94319e+09,3.73663e+09,4.55368e+06
19951004,596900,307000,289900,51758,1.9505e+09,3.69739e+09,4.45804e+06
19951005,596800,298100,298700,-19011,1.94952e+09,3.71173e+09,3.71695e+06
19951006,597500,291500,306000,27338,1.95395e+09,3.71969e+09,3.15546e+06
19951009,597800,285300,312500,76790,1.96384e+09,3.68371e+09,2.86628e+06
19951010,598500,269500,329000,19259,1.96552e+09,3.68363e+09,2.04324e+06
19951011,598600,280500,318100,-20527,1.96051e+09,3.71064e+09,2.64345e+06
19951012,598300,284500,313800,-34802,1.95301e+09,3.73367e+09,2.71914e+06
19951013,598200,296600,301600,27474,1.96233e+09,3.74757e+09,2.90548e+06
19951016,596400,313900,282500,33724,1.96694e+09,3.72558e+09,4.20887e+06
19951017,594900,327400,267500,-7154,1.96764e+09,3.73767e+09,5.9933e+06
19951018,594100,349800,244300,37420,1.97265e+09,3.74843e+09,7.44642e+06
19951019,593600,366700,226900,107605,1.99329e+09,3.74345e+09,8.50543e+06
19951020,593400,378700,214700,-5579,1.99125e+09,3.72112e+09,8.84453e+06
19951023,593500,381600,211900,-34955,1.98787e+09,3.71594e+09,8.81908e+06
19951024,594600,377100,217500,15099,1.99147e+09,3.71151e+09,8.36831e+06
19951025,594000,372400,221600,-41817,1.98415e+09,3.67555e+09,7.79543e+06
19951026,595300,342400,252900,-28994,1.98054e+09,3.65708e+09,5.83978e+06
19951027,595400,314800,280600,-41258,1.97586e+09,3.67267e+09,4.23281e+06
19951030,595800,306800,289000,84277,1.98707e+09,3.70515e+09,3.83566e+06
19951031,596800,287600,309200,-36419,1.9804e+09,3.67082e+09,2.85748e+06
19951101,597600,268000,329600,-6583,1.98001e+09,3.69768e+09,2.21217e+06
19951102,597200,306700,290500,34636,1.9876e+09,3.73658e+09,4.46781e+06
19951103,597100,312100,285000,57907,1.99985e+09,3.75236e+09,5.13422e+06
19951106,596700,335400,261300,-12359,1.99805e+09,3.73492e+09,6.40806e+06
19951107,597500,351000,246500,-32046,1.98973e+09,3.71419e+09,7.44294e+06
19951108,596700,385400,211300,89183,2.00058e+09,3.72451e+09,9.38861e+06
19951109,595600,398000,197600,44512,2.00646e+09,3.74009e+09,9.89538e+06
19951110,596200,409200,187000,43960,2.01717e+09,3.74379e+09,1.04128e+07
19951113,595200,426300,168900,-39963,2.01141e+09,3.73647e+09,1.12962e+07
19951114,595900,431200,164700,-34169,2.00031e+09,3.7172e+09,1.12875e+07
19951115,594500,429500,165000,55891,2.00598e+09,3.72918e+09,1.12996e+07
19951116,594800,431100,163700,83800,2.01634e+09,3.74252e+09,1.13762e+07
19951117,594700,437200,157500,59721,2.02632e+09,3.75152e+09,1.15927e+07
19951120,597200,421400,175800,5085,2.02548e+09,3.74211e+09,1.06713e+07
19951121,596600,423900,172700,41278,2.02961e+09,3.74497e+09,1.08228e+07
19951122,594200,427100,167100,19748,2.03088e+09,3.72031e+09,1.12639e+07
19951124,594400,426900,167500,-1479,2.03068e+09,3.74111e+09,1.12659e+07
19951127,597600,411800,185800,20512,2.03237e+09,3.77042e+09,1.09589e+07
19951128,599900,467500,132400,-15189,2.03276e+09,3.82463e+09,1.14495e+07
19951129,600800,473700,127100,-56941,2.01221e+09,3.81061e+09,1.16278e+07
19951130,600300,479800,120500,27336,2.01384e+09,3.80743e+09,1.22489e+07
19951201,615100,437000,178100,-3040,2.01615e+09,3.85183e+09,1.25824e+07
19951204,614400,463100,151300,53681,2.02698e+09,3.84845e+09,1.36676e+07
19951205,613800,472000,141800,108537,2.04392e+09,3.86372e+09,1.3898e+07
19951206,611100,479200,131900,56052,2.05195e+09,3.85535e+09,1.42661e+07
19951207,610600,482900,127700,-96920,2.03742e+09,3.83315e+09,1.44127e+07
19951208,608900,473000,135900,-27969,2.03538e+09,3.82102e+09,1.41011e+07
19951211,608400,465800,142600,14183,2.03646e+09,3.82305e+09,1.37854e+07
19951212,607600,448500,159100,30496,2.0409e+09,3.8052e+09,1.28139e+07
19951213,607500,443300,164200,43350,2.04751e+09,3.81348e+09,1.27044e+07
19951214,608000,435900,172100,-45279,2.03652e+09,3.79838e+09,1.20728e+07
19951215,611000,438500,172500,4921,2.03663e+09,3.80134e+09,1.21724e+07
19951218,614400,416600,197800,-141148,2.01745e+09,3.75669e+09,9.95097e+06
19951219,618700,384100,234600,-53807,2.01022e+09,3.82143e+09,7.6104e+06
19951220,618600,367500,251100,10665,2.01445e+09,3.81115e+09,6.39697e+06
19951221,618000,353300,264700,32561,2.01773e+09,3.81987e+09,5.24591e+06
19951222,616500,346400,270100,-2002,2.01674e+09,3.8219e+09,4.59017e+06
19951226,616700,346400,270300,59673,2.02506e+09,3.83863e+09,4.52233e+06
19951227,614900,352900,262000,31026,2.02519e+09,3.82774e+09,4.76136e+06
19951228,614900,361500,253400,19804,2.03258e+09,3.81395e+09,5.3442e+06
19951229,613800,374200,239600,18449,2.03692e+09,3.82635e+09,6.07418e+06
19960102,613600,386300,227300,982,2.03772e+09,3.83783e+09,7.20307e+06
19960103,613600,399600,214000,-11765,2.03704e+09,3.82914e+09,8.07339e+06
19960104,612900,410700,202200,-97937,2.02007e+09,3.79354e+09,8.68453e+06
19960105,612700,492700,120000,-11448,2.02084e+09,3.77854e+09,9.76324e+06
19960108,614000,500000,114000,5972,2.02207e+09,3.80449e+09,1.01119e+07
19960109,615800,484300,131500,19460,2.02625e+09,3.77025e+09,9.31046e+06
19960110,618200,457000,161200,-124810,2.00122e+09,3.72418e+09,7.04298e+06
19960111,619400,428400,191000,-67220,1.99251e+09,3.76706e+09,5.11185e+06
19960112,620300,400700,219600,-34217,1.98789e+09,3.77157e+09,3.50553e+06
19960115,622500,354900,267600,93313,2.00187e+09,3.77373e+09,1.09396e+06
19960116,651800,250900,400900,9112,2.00534e+09,3.94918e+09,-1.18958e+06
19960117,653500,248800,404700,-20612,2.00335e+09,3.96308e+09,-1.61512e+06
19960118,652800,254100,398700,-23925,1.99689e+09,3.97709e+09,-84549
19960119,652200,278400,373800,-7640,1.99463e+09,3.98881e+09,1.6339e+06
19960122,651400,293100,358300,-42621,1.98789e+09,4.01416e+09,2.67114e+06
19960123,648300,398200,250100,18117,1.99043e+09,3.99753e+09,3.62978e+06
19960124,623200,398600,224600,63437,1.99763e+09,3.91541e+09,5.51848e+06
19960125,621800,411200,210600,9985,2.00076e+09,3.90361e+09,6.70027e+06
19960126,619900,421500,198400,51336,2.00985e+09,3.91548e+09,7.33136e+06
19960129,620000,444500,175500,51931,2.01771e+09,3.92998e+09,8.67777e+06
19960130,618200,464900,153300,107790,2.03645e+09,3.94955e+09,1.03083e+07
19960131,616600,486900,129700,92805,2.05195e+09,3.98032e+09,1.196e+07
19960201,614900,505000,109900,37411,2.05797e+09,3.98997e+09,1.28193e+07
19960202,629000,452800,176200,-52478,2.04859e+09,4.03789e+09,1.4021e+07
19960205,628400,468600,159800,139269,2.06885e+09,4.05379e+09,1.48202e+07
19960206,628600,482000,146600,93108,2.08002e+09,4.08421e+09,1.55023e+07
19960207,628200,489300,138900,21185,2.08577e+09,4.08696e+09,1.60868e+07
19960208,627900,497300,130600,165120,2.11213e+09,4.12168e+09,1.64676e+07
19960209,627700,499700,128000,21828,2.11885e+09,4.12464e+09,1.65553e+07
19960212,627600,497700,129900,104736,2.13676e+09,4.14639e+09,1.65299e+07
19960213,627300,500200,127100,-59534,2.12807e+09,4.13637e+09,1.6831e+07
19960214,627600,491600,136000,-36454,2.11978e+09,4.12789e+09,1.63334e+07
19960215,626900,487600,139300,-32702,2.11519e+09,4.11485e+09,1.60346e+07
19960216,628000,476000,152000,-73968,2.10481e+09,4.11186e+09,1.51658e+07
19960220,621000,544400,76600,-202972,2.07182e+09,4.02138e+09,1.46206e+07
19960221,621900,533300,88600,116344,2.08826e+09,4.06198e+09,1.4076e+07
19960222,621400,536100,85300,229173,2.12447e+09,4.12131e+09,1.39311e+07
19960223,619800,539000,80800,6596,2.12548e+09,4.10703e+09,1.38521e+07
19960226,619600,523800,95800,-107743,2.10904e+09,4.07119e+09,1.26345e+07
19960227,619000,530000,89000,-78407,2.10076e+09,4.04427e+09,1.26792e+07
19960228,620500,522100,98400,-22219,2.09166e+09,4.04145e+09,1.18675e+07
19960229,621300,484300,137000,-44226,2.08156e+09,4.02461e+09,9.41077e+06
19960301,620600,440800,179800,15018,2.08079e+09,4.02321e+09,6.58517e+06
19960304,620200,427600,192600,92227,2.09667e+09,4.05828e+09,5.83428e+06
19960305,630900,346300,284600,-12440,2.09337e+09,4.12964e+09,6.0956e+06
19960306,629700,344500,285200,5499,2.09379e+09,4.1071e+09,6.23044e+06
19960307,628200,369900,258300,-9131,2.09114e+09,4.11058e+09,7.77794e+06
19960308,627500,363100,264400,-188684,2.06646e+09,3.99707e+09,6.88999e+06
19960311,632200,338300,293900,24782,2.06809e+09,4.07111e+09,5.41806e+06
19960312,633100,310500,322600,29817,2.07009e+09,4.07042e+09,3.29592e+06
19960313,632300,286500,345800,13037,2.06588e+09,4.08522e+09,1.62318e+06
19960314,631000,275400,355600,13534,2.06441e+09,4.09451e+09,885098
19960315,630700,286400,344300,-19297,2.06455e+09,4.09193e+09,1.94399e+06
19960318,630500,299700,330800,7356,2.06863e+09,4.15235e+09,3.33563e+06
19960319,629500,314100,315400,-4718,2.06824e+09,4.13907e+09,3.90898e+06
19960320,628300,361300,267000,-34591,2.06053e+09,4.11863e+09,6.77384e+06
19960321,627800,377900,249900,-19839,2.05907e+09,4.11e+09,7.96856e+06
19960322,626000,407500,218500,31214,2.06229e+09,4.11362e+09,1.00054e+07
19960325,625000,412600,212400,-9867,2.05892e+09,4.10001e+09,1.05264e+07
19960326,631900,409600,222300,-2367,2.05715e+09,4.20596e+09,1.05793e+07
19960327,631800,426600,205200,-20316,2.05481e+09,4.19017e+09,1.1416e+07
19960328,630000,418600,211400,-92,2.05544e+09,4.176e+09,1.1016e+07
19960329,630400,425000,205400,-21957,2.04912e+09,4.16543e+09,1.08732e+07
19960401,630400,417200,213200,102763,2.06217e+09,4.20116e+09,1.03559e+07
19960402,629200,416500,212700,-11383,2.06057e+09,4.1992e+09,9.83633e+06
19960403,629000,408400,220600,-32643,2.05873e+09,4.19928e+09,9.44202e+06
19960404,628900,401500,227400,62896,2.06916e+09,4.20543e+09,9.52525e+06
19960408,618700,473100,145600,-156557,2.04393e+09,4.10488e+09,9.37684e+06
19960409,619200,467500,151700,44046,2.05215e+09,4.11245e+09,9.08382e+06
19960410,622900,424700,198200,-28165,2.04997e+09,4.09119e+09,5.96097e+06
19960411,626500,372100,254400,37413,2.05788e+09,4.08963e+09,1.71881e+06
19960412,628300,353200,275100,-48168,2.04945e+09,4.1363e+09,268407
19960415,628300,348400,279900,5819,2.0506e+09,4.16321e+09,-210745
19960416,628500,346300,282200,53930,2.05871e+09,4.17861e+09,-832128
19960417,629100,356800,272300,38217,2.06204e+09,4.16589e+09,-495883
19960418,627200,382000,245200,24798,2.06579e+09,4.18036e+09,959902
19960419,624500,407200,217300,21729,2.07097e+09,4.16607e+09,2.78096e+06
19960422,621000,418400,202600,43452,2.07566e+09,4.16824e+09,4.01208e+06
19960423,619800,426300,193500,-5195,2.0816e+09,4.17684e+09,4.86064e+06
19960424,619200,446700,172500,63469,2.09033e+09,4.18645e+09,6.61562e+06
19960425,618400,453500,164900,71436,2.0994e+09,4.20806e+09,7.15512e+06
19960426,617300,473900,143400,7423,2.09772e+09,4.21568e+09,8.73092e+06
19960429,615900,492100,123800,-17812,2.09743e+09,4.20207e+09,1.00509e+07
19960430,615100,503900,111200,-33935,2.09361e+09,4.18754e+09,1.09793e+07
19960501,612900,524600,88300,25810,2.09944e+09,4.17547e+09,1.27641e+07
19960502,614500,526600,87900,-178458,2.0698e+09,4.12454e+09,1.26328e+07
19960503,614700,524200,90500,13749,2.07123e+09,4.1215e+09,1.22991e+07
19960506,614600,509100,105500,-4736,2.06269e+09,4.10971e+09,1.1433e+07
19960507,614600,491200,123400,-11146,2.06117e+09,4.09279e+09,1.02075e+07
19960508,615800,476000,139800,59436,2.07521e+09,4.11352e+09,8.98288e+06
19960509,616400,460400,156000,47288,2.08061e+09,4.13089e+09,8.18851e+06
19960510,616500,454700,161800,43218,2.08926e+09,4.17115e+09,7.99067e+06
19960513,615600,466400,149200,110729,2.10333e+09,4.21296e+09,8.94607e+06
19960514,612700,484100,128600,63952,2.11202e+09,4.22009e+09,1.00447e+07
19960515,611800,508400,103400,-23248,2.10991e+09,4.20565e+09,1.24891e+07
19960516,611700,522400,89300,-12816,2.11075e+09,4.20282e+09,1.36612e+07
19960517,609400,528400,81000,49001,2.11662e+09,4.2066e+09,1.41152e+07
19960520,607900,523000,84900,65589,2.12615e+09,4.21363e+09,1.40047e+07
19960521,607500,520500,87000,15809,2.12662e+09,4.20975e+09,1.38911e+07
19960522,575300,447500,127800,48300,2.1373e+09,4.03508e+09,1.40622e+07
19960523,574300,447400,126900,-39357,2.13029e+09,4.01652e+09,1.39758e+07
19960524,574800,446700,128100,8904,2.13345e+09,4.01925e+09,1.38782e+07
19960528,574200,441900,132300,-137314,2.11252e+09,3.97783e+09,1.333e+07
19960529,574200,434300,139900,-96055,2.10216e+09,3.93952e+09,1.26116e+07
19960530,573100,420000,153100,27470,2.10792e+09,3.9556e+09,1.20327e+07
19960531,573800,409700,164100,-45558,2.09955e+09,3.95622e+09,1.14029e+07
19960603,573700,389000,184700,28846,2.10565e+09,3.94607e+09,9.99051e+06
19960604,573400,380600,192800,102358,2.12068e+09,3.95461e+09,9.36164e+06
19960605,573600,379500,194100,101390,2.1368e+09,3.97354e+09,9.48116e+06
19960606,573800,369200,204600,-10261,2.13804e+09,3.93359e+09,8.7503e+06
19960607,573500,346800,226700,-86553,2.13091e+09,3.86144e+09,7.34921e+06
19960610,573600,354000,219600,51556,2.13755e+09,3.84054e+09,7.40692e+06
19960611,573900,353700,220200,-52265,2.1337e+09,3.82359e+09,7.36252e+06
19960612,573500,341500,232000,-45280,2.12543e+09,3.80631e+09,6.49312e+06
19960613,561500,370600,190900,27813,2.1283e+09,3.73591e+09,5.77608e+06
19960614,562800,353600,209200,-492,2.12973e+09,3.73166e+09,4.70652e+06
19960617,562200,343900,218300,18423,2.13191e+09,3.72006e+09,4.20465e+06
19960618,562200,337600,224600,12109,2.13406e+09,3.70449e+09,3.60584e+06
19960619,561900,320600,241300,-5984,2.13358e+09,3.69801e+09,2.25545e+06
19960620,567400,268100,299300,20267,2.13832e+09,3.7043e+09,1.43822e+06
19960621,567200,267900,299300,39204,2.14639e+09,3.72301e+09,1.49479e+06
19960624,567400,265300,302100,-4538,2.14759e+09,3.7357e+09,1.05031e+06
19960625,560900,301700,259200,22190,2.15309e+09,3.70347e+09,2.16682e+06
19960626,561300,299000,262300,43221,2.15863e+09,3.67763e+09,2.79914e+06
19960627,560500,311900,248600,11942,2.15986e+09,3.69459e+09,3.6751e+06
19960628,559700,328200,231500,29749,2.16301e+09,3.72616e+09,4.4629e+06
19960701,559500,333200,226300,1225,2.16774e+09,3.74651e+09,4.89666e+06
19960702,558700,342900,215800,7110,2.16841e+09,3.72532e+09,5.35512e+06
19960703,558400,374100,184300,48257,2.17857e+09,3.71384e+09,7.28586e+06
19960705,558500,385200,173300,-156632,2.15537e+09,3.64354e+09,7.59815e+06
19960708,559600,376400,183200,-29586,2.15127e+09,3.62146e+09,6.72148e+06
19960709,560400,360300,200100,72164,2.1609e+09,3.63689e+09,5.63054e+06
19960710,563300,323800,239500,27977,2.16847e+09,3.64414e+09,3.51621e+06
19960711,567200,280800,286400,88611,2.18141e+09,3.60145e+09,318366
19960712,569300,258200,311100,31018,2.18356e+09,3.60828e+09,-1.49229e+06
19960715,573300,225400,347900,228923,2.21564e+09,3.53526e+09,-3.6371e+06
19960716,576600,184400,392200,41086,2.22446e+09,3.52355e+09,-6.50462e+06
19960717,577100,169800,407300,-188171,2.19638e+09,3.56931e+09,-8.20478e+06
19960718,577800,166300,411500,-218129,2.15802e+09,3.60445e+09,-8.85679e+06
19960719,578200,153300,424900,88912,2.17038e+09,3.57951e+09,-8.99435e+06
19960722,578200,158500,419700,104316,2.18963e+09,3.55184e+09,-8.46502e+06
19960723,579100,166300,412800,122850,2.20607e+09,3.52374e+09,-8.00081e+06
19960724,576900,135400,441500,93023,2.21871e+09,3.4852e+09,-7.77301e+06
19960725,577200,131600,445600,-63403,2.20715e+09,3.51174e+09,-7.9589e+06
19960726,576500,134500,442000,-76872,2.19731e+09,3.54045e+09,-7.83068e+06
19960729,576200,147600,428600,77169,2.20657e+09,3.50121e+09,-6.36845e+06
19960730,575800,157900,417900,393,2.20582e+09,3.51899e+09,-5.26863e+06
19960731,576000,186400,389600,25435,2.20843e+09,3.53684e+09,-3.26946e+06
19960801,576100,233100,343000,24838,2.21441e+09,3.58905e+09,-140155
19960802,574100,293000,281100,70621,2.22369e+09,3.64301e+09,3.6896e+06
19960805,579000,358100,220900,-57647,2.21383e+09,3.66522e+09,8.15793e+06
19960806,580600,395300,185300,71422,2.22217e+09,3.67993e+09,1.04633e+07
19960807,581400,432800,148600,102928,2.23329e+09,3.71265e+09,1.30465e+07
19960808,583100,458300,124800,-2674,2.23212e+09,3.72931e+09,1.37055e+07
19960809,585600,481500,104100,-39961,2.22972e+09,3.74162e+09,1.48162e+07
19960812,586200,488400,97800,69827,2.24053e+09,3.76117e+09,1.51252e+07
19960813,587800,490700,97100,-120306,2.22371e+09,3.73954e+09,1.49197e+07
19960814,587800,494100,93700,70000,2.23304e+09,3.75796e+09,1.5088e+07
19960815,587400,500500,86900,35422,2.23712e+09,3.763e+09,1.55635e+07
19960816,589300,492100,97200,38207,2.24266e+09,3.78248e+09,1.53942e+07
19960819,590200,499700,90500,41175,2.25081e+09,3.79483e+09,1.56807e+07
19960820,590300,535900,54400,-38255,2.24478e+09,3.79622e+09,1.58239e+07
19960821,590400,538800,51600,18920,2.25032e+09,3.79757e+09,1.59518e+07
19960822,590200,537400,52800,95557,2.26332e+09,3.82038e+09,1.58118e+07
19960823,590700,532300,58400,-62642,2.25192e+09,3.80643e+09,1.53919e+07
19960826,595100,514400,80700,-38411,2.24706e+09,3.83571e+09,1.46774e+07
19960827,595500,514900,80600,73132,2.261e+09,3.85244e+09,1.46627e+07
19960828,598200,513900,84300,72565,2.2706e+09,3.8848e+09,1.397e+07
19960829,599600,487700,111900,-101556,2.25442e+09,3.8662e+09,1.24359e+07
19960830,600000,464700,135300,-81889,2.24094e+09,3.84482e+09,1.11596e+07
19960903,600300,452400,147900,-15453,2.23643e+09,3.85101e+09,1.05624e+07
19960904,600300,436000,164300,22157,2.24019e+09,3.8541e+09,9.16168e+06
19960905,609700,368100,241600,-28215,2.23494e+09,3.86284e+09,6.39832e+06
19960906,609200,356600,252600,51280,2.24506e+09,3.89118e+09,5.61819e+06
19960909,608300,357800,250500,40862,2.25061e+09,3.92088e+09,5.64645e+06
19960910,608600,373700,234900,-5515,2.25009e+09,3.91801e+09,6.39184e+06
19960911,608500,406100,202400,39565,2.25544e+09,3.93318e+09,8.73626e+06
19960912,616400,454200,162200,63626,2.26455e+09,4.00007e+09,1.029e+07
19960913,618800,476300,142500,142751,2.28731e+09,4.08758e+09,1.20734e+07
19960916,616600,492200,124400,15443,2.29321e+09,4.07623e+09,1.28721e+07
19960917,609300,473700,135600,-12458,2.29133e+09,4.02947e+09,1.40848e+07
19960918,607300,484000,123300,-53342,2.28529e+09,3.99841e+09,1.46959e+07
19960919,607200,485000,122200,28094,2.28854e+09,4.01167e+09,1.48275e+07
19960920,612700,488900,123800,87008,2.3009e+09,4.04743e+09,1.50859e+07
19960923,611300,482000,129300,-11328,2.29961e+09,4.03574e+09,1.46642e+07
19960924,610300,471000,139300,85375,2.31299e+09,4.04452e+09,1.41037e+07
19960925,610100,471100,139000,2585,2.31425e+09,4.04655e+09,1.42287e+07
19960926,607800,481300,126500,13961,2.32204e+09,4.01807e+09,1.45989e+07
19960927,606100,491000,115100,16927,2.32344e+09,4.00814e+09,1.51795e+07
19960930,606500,490500,116000,6704,2.32513e+09,4.01775e+09,1.50893e+07
19961001,606300,483100,123200,-16328,2.32294e+09,4.00937e+09,1.49279e+07
19961002,605600,500100,105500,66544,2.33179e+09,4.02331e+09,1.50918e+07
19961003,605000,497000,108000,-10049,2.32772e+09,4.02381e+09,1.48241e+07
19961004,605100,508200,96900,176176,2.35647e+09,4.06047e+09,1.55853e+07
19961007,605000,498200,106800,21781,2.35982e+09,4.05355e+09,1.4999e+07
19961008,604000,519500,84500,-16304,2.35718e+09,4.03129e+09,1.43428e+07
19961009,603300,500900,102400,-61322,2.34788e+09,4.01251e+09,1.3668e+07
19961010,603500,482800,120700,-16793,2.34697e+09,4.01116e+09,1.24677e+07
19961011,602700,481700,121000,67567,2.35565e+09,4.03692e+09,1.23063e+07
19961014,602300,472500,129800,87600,2.3697e+09,4.05196e+09,1.16625e+07
19961015,602000,469800,132200,-31204,2.36398e+09,4.05325e+09,1.15181e+07
19961016,601300,450500,150800,-15902,2.36104e+09,4.04473e+09,1.13715e+07
19961017,601000,453100,147900,78025,2.37391e+09,4.05988e+09,1.1811e+07
19961018,610300,424600,185700,59337,2.38597e+09,4.11672e+09,1.19901e+07
19961021,609600,421300,188300,-9009,2.38624e+09,4.10393e+09,1.18277e+07
19961022,608200,424100,184100,-49759,2.3777e+09,4.06827e+09,1.18559e+07
19961023,608000,410000,198000,6052,2.37986e+09,4.0735e+09,1.12531e+07
19961024,608500,401600,206900,-54346,2.37386e+09,4.04038e+09,1.09892e+07
19961025,609600,383200,226400,-3969,2.37299e+09,4.04285e+09,1.00256e+07
19961028,610400,366100,244300,9673,2.37537e+09,4.02614e+09,8.86164e+06
19961029,610500,348100,262400,62248,2.38734e+09,4.03352e+09,7.86218e+06
19961030,610800,334800,276000,9529,2.38931e+09,4.03541e+09,6.7895e+06
19961031,610000,329900,280100,30134,2.39046e+09,4.05258e+09,6.5674e+06
19961101,610400,330100,280300,13289,2.39456e+09,4.04916e+09,6.38964e+06
19961104,609600,319600,290000,25552,2.39753e+09,4.06231e+09,5.5272e+06
19961105,609300,327300,282000,8551,2.39808e+09,4.08224e+09,6.1185e+06
19961106,607400,365800,241600,137464,2.41776e+09,4.13473e+09,8.12768e+06
19961107,605700,375300,230400,46985,2.42652e+09,4.14279e+09,9.11093e+06
19961108,602700,441300,161400,32609,2.43277e+09,4.13349e+09,1.10217e+07
19961111,605100,465600,139500,84923,2.4461e+09,4.16189e+09,1.22887e+07
19961112,604000,471800,132200,-20580,2.44249e+09,4.15011e+09,1.28041e+07
19961113,603600,492300,111300,62221,2.45257e+09,4.15681e+09,1.40233e+07
19961114,601800,499500,102300,41686,2.46234e+09,4.1654e+09,1.43226e+07
19961115,601600,504700,96900,3352,2.46193e+09,4.17224e+09,1.49217e+07
19961118,601600,512200,89400,3193,2.46226e+09,4.17418e+09,1.53952e+07
19961119,603100,503800,99300,56738,2.4726e+09,4.21155e+09,1.53166e+07
19961120,602200,514300,87900,74160,2.48507e+09,4.22061e+09,1.57325e+07
19961121,602400,518000,84400,6574,2.4866e+09,4.21958e+09,1.57133e+07
19961122,601600,521600,80000,140723,2.50706e+09,4.25415e+09,1.60691e+07
19961125,604400,482800,121600,139825,2.52685e+09,4.31904e+09,1.64471e+07
19961126,602500,480000,122500,-37926,2.52022e+09,4.28768e+09,1.62362e+07
19961127,601600,477300,124300,2744,2.51876e+09,4.28298e+09,1.60902e+07
19961129,601900,471300,130600,23735,2.52324e+09,4.28839e+09,1.58815e+07
19961202,601600,463800,137800,34848,2.52459e+09,4.28904e+09,1.55456e+07
19961203,601600,451500,150100,-44262,2.51687e+09,4.26351e+09,1.44041e+07
19961204,602000,448100,153900,-73254,2.50443e+09,4.24682e+09,1.32007e+07
19961205,602100,443200,158900,15578,2.50891e+09,4.25352e+09,1.2809e+07
19961206,601000,429200,171800,-86793,2.49606e+09,4.21271e+09,1.12266e+07
19961209,599400,421300,178100,95273,2.50857e+09,4.22324e+09,1.01946e+07
19961210,599700,432900,166800,26366,2.51229e+09,4.20125e+09,9.84582e+06
19961211,599500,425600,173900,-32913,2.49907e+09,4.11291e+09,8.76119e+06
19961212,599700,392600,207100,-47076,2.48906e+09,4.06321e+09,6.14429e+06
19961213,601100,357100,244000,-87438,2.47672e+09,4.06426e+09,3.77809e+06
19961216,602300,314800,287500,-40694,2.47015e+09,4.03422e+09,254703
19961217,603700,284800,318900,-45111,2.46474e+09,4.0544e+09,-2.41678e+06
19961218,604400,253900,350500,6671,2.462e+09,4.09733e+09,-3.85706e+06
19961219,603800,254900,348900,-60465,2.45268e+09,4.1573e+09,-3.7842e+06
19961220,602700,282300,320400,-62659,2.4416e+09,4.17598e+09,-987098
19961223,600400,307200,293200,49036,2.45393e+09,4.14723e+09,1.11379e+06
19961224,598400,337200,261200,25746,2.45777e+09,4.14118e+09,4.49387e+06
19961226,597000,370100,226900,38390,2.46353e+09,4.15591e+09,7.1897e+06
19961227,595000,439700,155300,66647,2.47566e+09,4.14548e+09,9.27451e+06
19961230,606100,444100,162000,3919,2.47323e+09,4.20398e+09,1.0371e+07
19961231,605500,457900,147600,-119776,2.45791e+09,4.14432e+09,1.14693e+07
19970102,606800,410900,195900,-163115,2.43063e+09,4.0944e+09,1.16124e+07
19970103,606000,405000,201000,103230,2.44811e+09,4.15549e+09,1.17953e+07
19970106,606000,414100,191900,44620,2.45347e+09,4.16589e+09,1.18281e+07
19970107,604300,419400,184900,35023,2.4576e+09,4.17977e+09,1.19677e+07
19970108,602000,424300,177700,-11614,2.45225e+09,4.15097e+09,1.25085e+07
19970109,601800,439600,162200,79399,2.46684e+09,4.17475e+09,1.35548e+07
19970110,600400,502700,97700,44760,2.47682e+09,4.18073e+09,1.40496e+07
19970113,601900,493900,108000,-13634,2.47407e+09,4.17836e+09,1.37684e+07
19970114,601500,492100,109400,128088,2.49141e+09,4.21967e+09,1.37738e+07
19970115,600300,483800,116500,-95584,2.47857e+09,4.16994e+09,1.33998e+07
19970116,599700,482600,117100,58105,2.48526e+09,4.18788e+09,1.35634e+07
19970117,593400,416200,177200,72391,2.4979e+09,4.17696e+09,1.32448e+07
19970120,593000,413600,179400,22125,2.50314e+09,4.18196e+09,1.32622e+07
19970121,591900,415700,176200,90247,2.52105e+09,4.18888e+09,1.35631e+07
19970122,591100,412200,178900,54571,2.52875e+09,4.19085e+09,1.34475e+07
19970123,591100,417100,174000,-106534,2.5111e+09,4.17658e+09,1.34734e+07
19970124,591400,421300,170100,-101073,2.49623e+09,4.14804e+09,1.26326e+07
19970127,591800,407200,184600,-65508,2.48895e+09,4.12604e+09,1.12846e+07
19970128,594300,382000,212300,6227,2.48713e+09,4.1593e+09,9.18805e+06
19970129,595200,383700,211500,40737,2.49357e+09,4.18635e+09,8.9268e+06
19970130,594600,372400,222200,100520,2.50525e+09,4.23682e+09,8.43869e+06
19970131,594100,372900,221200,70118,2.51712e+09,4.24395e+09,8.73079e+06
19970203,593200,370000,223200,-5199,2.51857e+09,4.23459e+09,8.59069e+06
19970204,591700,371100,220600,22928,2.52297e+09,4.23299e+09,8.83076e+06
19970205,591100,433800,157300,-91890,2.51039e+09,4.18502e+09,9.31953e+06
19970206,592300,438400,153900,57701,2.52117e+09,4.20235e+09,9.31086e+06
19970207,593600,433600,160000,116123,2.53796e+09,4.24753e+09,9.21869e+06
19970210,594000,418000,176000,33648,2.54244e+09,4.23572e+09,8.71721e+06
19970211,593200,404700,188500,37637,2.5465e+09,4.23619e+09,7.67736e+06
19970212,591500,404300,187200,52565,2.55383e+09,4.29009e+09,7.89264e+06
19970213,590900,416000,174900,108064,2.57087e+09,4.32939e+09,8.97488e+06
19970214,590200,434100,156100,-827,2.56713e+09,4.32243e+09,1.01771e+07
19970218,588700,453700,135000,87455,2.58493e+09,4.32424e+09,1.13043e+07
19970219,589000,464400,124600,-72913,2.57282e+09,4.31759e+09,1.23186e+07
19970220,588600,478700,109900,-91192,2.55924e+09,4.27708e+09,1.29777e+07
19970221,587100,473200,113900,-5782,2.56061e+09,4.25098e+09,1.25656e+07
19970224,586900,481400,105500,109958,2.57567e+09,4.28485e+09,1.3137e+07
19970225,587400,475800,111600,77075,2.58947e+09,4.30694e+09,1.28574e+07
19970226,585300,459100,126200,-74278,2.5798e+09,4.25785e+09,1.18718e+07
19970227,586400,452900,133500,-51648,2.57408e+09,4.21767e+09,1.12272e+07
19970228,588200,433500,154700,-30893,2.56303e+09,4.21315e+09,1.04012e+07
19970303,596100,375900,220200,43719,2.56346e+09,4.26577e+09,9.40557e+06
19970304,599400,360700,238700,-2569,2.56224e+09,4.3066e+09,7.66505e+06
19970305,598300,349200,249100,24917,2.56736e+09,4.34648e+09,6.45785e+06
19970306,597500,346000,251500,-35839,2.56603e+09,4.32446e+09,6.43672e+06
19970307,596300,353000,243300,84172,2.58104e+09,4.34317e+09,6.9408e+06
19970310,596000,353900,242100,92901,2.59782e+09,4.37772e+09,7.39604e+06
19970311,593800,370700,223100,-9128,2.59395e+09,4.35022e+09,9.26921e+06
19970312,593700,365700,228000,-55317,2.58488e+09,4.32834e+09,9.07387e+06
19970313,594800,362600,232200,-158030,2.55938e+09,4.27856e+09,8.78483e+06
19970314,596000,353000,243000,72057,2.569e+09,4.31407e+09,8.17664e+06
19970317,593800,330100,263700,3803,2.56861e+09,4.29049e+09,7.07252e+06
19970318,595400,298700,296700,-53267,2.56319e+09,4.2663e+09,4.76701e+06
19970319,595900,343600,252300,1690,2.56361e+09,4.24673e+09,3.43618e+06
19970320,596300,342500,253800,-12575,2.56502e+09,4.23718e+09,3.28935e+06
19970321,596800,331100,265700,5501,2.56531e+09,4.24114e+09,2.44915e+06
19970324,598000,326400,271600,39763,2.56907e+09,4.27029e+09,2.40729e+06
19970325,597500,322500,275000,-33158,2.56785e+09,4.26201e+09,1.86855e+06
19970326,597300,325600,271700,18475,2.5674e+09,4.27127e+09,2.30423e+06
19970327,597800,327200,270600,-37526,2.56454e+09,4.18288e+09,1.99479e+06
19970331,603000,292900,310100,64835,2.58089e+09,4.12556e+09,-1.4078e+06
19970401,605900,197900,408000,6537,2.58001e+09,4.13609e+09,-4.10062e+06
19970402,607700,233500,374200,96656,2.59765e+09,4.10852e+09,-5.778e+06
19970403,610100,195900,414200,84144,2.60853e+09,4.10169e+09,-8.31316e+06
19970404,603600,176700,426900,-131591,2.59089e+09,4.12035e+09,-9.66134e+06
19970407,603700,185100,418600,-77309,2.57927e+09,4.15787e+09,-9.59291e+06
19970408,602400,198100,404300,-26682,2.57389e+09,4.16352e+09,-8.2834e+06
19970409,601900,199200,402700,32237,2.57782e+09,4.13926e+09,-7.58583e+06
19970410,602000,219200,382800,-2724,2.57785e+09,4.12503e+09,-6.00852e+06
19970411,602800,246900,355900,165489,2.60978e+09,4.03605e+09,-5.08486e+06
19970414,602700,246700,356000,-25330,2.60376e+09,4.03571e+09,-5.26152e+06
19970415,604300,248500,355800,-31920,2.59848e+09,4.09625e+09,-5.15404e+06
19970416,607800,234200,373600,-5656,2.5957e+09,4.14947e+09,-4.96106e+06
19970417,607700,247900,359800,-7848,2.59619e+09,4.15185e+09,-3.7363e+06
19970418,607400,293400,314000,-9202,2.59402e+09,4.1605e+09,-241939
19970421,608800,312400,296400,2621,2.59254e+09,4.1288e+09,1.17281e+06
19970422,615800,281200,334600,98950,2.60817e+09,4.22266e+09,3.17122e+06
19970423,617100,300900,316200,-17644,2.60501e+09,4.24052e+09,4.44749e+06
19970424,617800,313900,303900,21199,2.60474e+09,4.24075e+09,5.7454e+06
19970425,617300,322900,294400,-4515,2.60227e+09,4.20271e+09,6.27715e+06
19970428,619000,326900,292100,61393,2.60946e+09,4.25065e+09,6.80179e+06
19970429,617900,399500,218400,156436,2.63651e+09,4.34164e+09,7.97141e+06
19970430,606000,414500,191500,69208,2.65052e+09,4.31266e+09,9.32167e+06
19970501,605600,445400,160200,-24554,2.64724e+09,4.31489e+09,1.02615e+07
19970502,603700,483200,120500,256361,2.68945e+09,4.38609e+09,1.28783e+07
19970505,599300,524000,75300,309916,2.7459e+09,4.44401e+09,1.56896e+07
19970506,600600,539200,61400,-52927,2.73681e+09,4.45236e+09,1.67659e+07
19970507,599800,559800,40000,-154553,2.71207e+09,4.40804e+09,1.75324e+07
19970508,600200,561600,38600,86992,2.72628e+09,4.43438e+09,1.78819e+07
19970509,600200,566500,33700,62529,2.73462e+09,4.45413e+09,1.78954e+07
19970512,600400,565000,35400,180297,2.76873e+09,4.4894e+09,1.7963e+07
19970513,600400,565000,35400,-35964,2.76304e+09,4.46651e+09,1.7927e+07
19970514,604100,565500,38600,59159,2.77395e+09,4.5154e+09,1.79058e+07
19970515,604400,569500,34900,5916,2.77959e+09,4.47596e+09,1.81489e+07
19970516,604500,568000,36500,-194540,2.74706e+09,4.42694e+09,1.784e+07
19970519,604800,559100,45700,59697,2.7571e+09,4.44358e+09,1.74126e+07
19970520,605000,554800,50200,146110,2.77899e+09,4.48013e+09,1.72e+07
19970521,602800,546500,56300,-6452,2.77666e+09,4.4615e+09,1.6702e+07
19970522,603800,536000,67800,-52071,2.76959e+09,4.43577e+09,1.63017e+07
19970523,603700,531000,72700,186673,2.79846e+09,4.48641e+09,1.61468e+07
19970527,604700,536400,68300,82028,2.81251e+09,4.50269e+09,1.61073e+07
19970528,604300,484200,120100,-118865,2.79323e+09,4.47226e+09,1.55201e+07
19970529,603900,476900,127000,-32705,2.79001e+09,4.4371e+09,1.52312e+07
19970530,607500,460300,147200,59390,2.80281e+09,4.46815e+09,1.52832e+07
19970602,609600,468500,141100,6826,2.8052e+09,4.45231e+09,1.52046e+07
19970603,609300,463100,146200,-43200,2.79917e+09,4.42568e+09,1.45048e+07
19970604,609000,458700,150300,1296,2.7944e+09,4.38789e+09,1.39983e+07
19970605,608900,457300,151600,93271,2.81119e+09,4.41063e+09,1.39806e+07
19970606,608900,451600,157300,162569,2.83462e+09,4.46838e+09,1.39032e+07
19970609,607600,443200,164400,-4280,2.83042e+09,4.47126e+09,1.34868e+07
19970610,606500,445500,161000,94312,2.84581e+09,4.46342e+09,1.3905e+07
19970611,605700,454200,151500,63350,2.85539e+09,4.46783e+09,1.41803e+07
19970612,603700,511000,92700,202155,2.886e+09,4.50859e+09,1.5166e+07
19970613,599500,501200,98300,113525,2.90407e+09,4.55032e+09,1.52368e+07
19970616,596600,507400,89200,-47407,2.89844e+09,4.51607e+09,1.57793e+07
19970617,596800,510100,86700,-12202,2.89799e+09,4.51547e+09,1.60063e+07
19970618,596600,513500,83100,-6197,2.89727e+09,4.50188e+09,1.63799e+07
19970619,592900,511600,81300,155971,2.92355e+09,4.50183e+09,1.65074e+07
19970620,592700,511000,81700,-19367,2.92226e+09,4.49544e+09,1.64804e+07
19970623,599200,460900,138300,-239394,2.88361e+09,4.46038e+09,1.55265e+07
19970624,599600,451100,148500,196835,2.91808e+09,4.51751e+09,1.51282e+07
19970625,599400,447600,151800,-83018,2.90464e+09,4.49468e+09,1.49078e+07
19970626,599100,437500,161600,-84172,2.89493e+09,4.46769e+09,1.42188e+07
19970627,598400,437400,161000,57577,2.90473e+09,4.48156e+09,1.32851e+07
19970630,599500,435200,164300,-14874,2.90191e+09,4.46063e+09,1.30201e+07
19970701,596900,421600,175300,50065,2.91508e+09,4.45119e+09,1.20544e+07
19970702,597200,426400,170800,147431,2.93833e+09,4.50421e+09,1.28535e+07
19970703,594700,428500,166200,158627,2.96541e+09,4.52859e+09,1.32124e+07
19970707,593400,447200,146200,-83203,2.95147e+09,4.49747e+09,1.43541e+07
19970708,590800,456800,134000,112415,2.97106e+09,4.50873e+09,1.53143e+07
19970709,587800,462900,124900,-109866,2.95262e+09,4.44303e+09,1.55021e+07
19970710,589500,467200,122300,120535,2.97252e+09,4.49026e+09,1.54e+07
19970711,587400,461900,125500,74344,2.98255e+09,4.49058e+09,1.52755e+07
19970714,585200,465300,119900,-51917,2.96954e+09,4.42219e+09,1.55004e+07
19970715,584100,467400,116700,143748,2.99365e+09,4.45934e+09,1.55708e+07
19970716,581800,510600,71200,107086,3.0141e+09,4.4687e+09,1.57135e+07
19970717,581200,514000,67200,-81249,3.00567e+09,4.4451e+09,1.58737e+07
19970718,576000,510600,65400,-159116,2.98031e+09,4.35975e+09,1.59106e+07
19970721,575800,508700,67100,-72444,2.96703e+09,4.33582e+09,1.58306e+07
19970722,576300,474500,101800,157521,2.99026e+09,4.39383e+09,1.51698e+07
19970723,577400,444500,132900,77430,3.00496e+09,4.41619e+09,1.42631e+07
19970724,576800,428400,148400,49470,3.01284e+09,4.42109e+09,1.31812e+07
19970725,576900,427700,149200,9145,3.01411e+09,4.41324e+09,1.33422e+07
19970728,575100,433100,142000,4572,3.01332e+09,4.39489e+09,1.33653e+07
19970729,573700,439100,134600,66667,3.02529e+09,4.40073e+09,1.3388e+07
19970730,574900,452500,122400,177177,3.05285e+09,4.47889e+09,1.38594e+07
19970731,574500,464900,109600,59791,3.06305e+09,4.48689e+09,1.46349e+07
19970801,572000,467700,104300,-90332,3.05241e+09,4.43616e+09,1.46162e+07
19970804,572600,468300,104300,-33735,3.05155e+09,4.43258e+09,1.46285e+07
19970805,570800,477300,93500,95021,3.06278e+09,4.44017e+09,1.50716e+07
19970806,571000,481500,89500,114935,3.08375e+09,4.46868e+09,1.50842e+07
19970807,569000,501200,67800,-47191,3.07782e+09,4.43291e+09,1.48826e+07
19970808,567400,487800,79600,-278847,3.03084e+09,4.3331e+09,1.38542e+07
19970811,566900,482600,84300,39876,3.03726e+09,4.33716e+09,1.2934e+07
19970812,567800,452100,115700,-70770,3.02686e+09,4.29624e+09,1.10789e+07
19970813,567200,433500,133700,6014,3.02818e+09,4.28359e+09,9.43308e+06
19970814,568000,417400,150600,15471,3.02976e+09,4.29571e+09,7.66708e+06
19970815,567900,404500,163400,-44366,3.02058e+09,4.2179e+09,6.40353e+06
19970818,567300,378100,189200,-28984,3.01701e+09,4.22651e+09,3.7374e+06
19970819,566200,362200,204000,17926,3.01994e+09,4.27454e+09,2.65554e+06
19970820,564900,357000,207900,8859,3.01818e+09,4.31913e+09,2.22249e+06
19970821,563500,312500,251000,23936,3.02478e+09,4.2585e+09,1.72851e+06
19970822,562400,321200,241200,5786,3.02456e+09,4.23713e+09,2.6971e+06
19970825,562400,340800,221600,171,3.02419e+09,4.22817e+09,4.40498e+06
19970826,562200,336300,225900,-19617,3.01897e+09,4.2037e+09,3.91086e+06
19970827,561800,335700,226100,46028,3.02661e+09,4.20664e+09,3.70106e+06
19970828,560700,339500,221200,-6679,3.02555e+09,4.16834e+09,3.69135e+06
19970829,559600,338900,220700,60998,3.04025e+09,4.14907e+09,3.56525e+06
19970902,552500,392800,159700,-4816,3.04417e+09,4.18642e+09,4.81513e+06
19970903,550600,406900,143700,98197,3.05715e+09,4.14902e+09,6.06426e+06
19970904,549700,432900,116800,18903,3.06195e+09,4.15203e+09,8.41513e+06
19970905,550400,466700,83700,20340,3.06531e+09,4.16668e+09,1.18722e+07
19970908,548200,486200,62000,68813,3.0746e+09,4.16188e+09,1.39488e+07
19970909,547300,483700,63600,60482,3.08695e+09,4.16147e+09,1.40979e+07
19970910,547700,480300,67400,-91132,3.07273e+09,4.12188e+09,1.36367e+07
19970911,548100,478000,70100,-45798,3.0706e+09,4.10011e+09,1.3256e+07
19970912,546700,476400,70300,224442,3.10863e+09,4.14924e+09,1.34222e+07
19970915,546900,469000,77900,-48721,3.09878e+09,4.13322e+09,1.27736e+07
19970916,546500,474600,71900,186852,3.12492e+09,4.21699e+09,1.34978e+07
19970917,545600,480200,65400,-29444,3.11899e+09,4.20066e+09,1.36366e+07
19970918,544900,487400,57500,62473,3.12828e+09,4.21648e+09,1.45566e+07
19970919,543300,481800,61500,71427,3.14184e+09,4.21246e+09,1.49328e+07
19970922,543500,485500,58000,80713,3.15845e+09,4.21227e+09,1.53746e+07
19970923,543400,483700,59700,-57369,3.15436e+09,4.19281e+09,1.51994e+07
19970924,543400,485300,58100,-60424,3.14864e+09,4.16545e+09,1.53663e+07
19970925,543500,482500,61000,-129932,3.12728e+09,4.13648e+09,1.4988e+07
19970926,543600,473400,70200,99521,3.14271e+09,4.15402e+09,1.42437e+07
19970929,541700,450100,91600,21076,3.14815e+09,4.1455e+09,1.27875e+07
19970930,541800,439300,102500,17042,3.15438e+09,4.13716e+09,1.22036e+07
19971001,540600,438100,102500,76049,3.16664e+09,4.13962e+09,1.24822e+07
19971002,540700,437300,103400,182431,3.20322e+09,4.15265e+09,1.24781e+07
19971003,531700,440600,91100,58198,3.21375e+09,4.12028e+09,1.3143e+07
19971006,531300,444700,86600,103037,3.22964e+09,4.13311e+09,1.37365e+07
19971007,530300,445100,85200,108762,3.24767e+09,4.15884e+09,1.39276e+07
19971008,529600,454600,75000,-104316,3.23024e+09,4.12543e+09,1.41645e+07
19971009,528500,450700,77800,-37075,3.22319e+09,4.11278e+09,1.41269e+07
19971010,528300,449100,79200,-60588,3.21518e+09,4.08023e+09,1.39547e+07
19971013,528400,448800,79600,25151,3.22009e+09,4.08418e+09,1.38603e+07
19971014,530100,443200,86900,-63116,3.21029e+09,4.06838e+09,1.29944e+07
19971015,529000,435600,93400,-12980,3.20886e+09,4.05083e+09,1.20955e+07
19971016,528900,425600,103300,-116947,3.18873e+09,3.99098e+09,1.12306e+07
19971017,529800,392200,137600,-88992,3.17141e+09,3.94302e+09,8.94427e+06
19971020,530500,384000,146500,69998,3.18584e+09,3.99191e+09,8.31754e+06
19971021,529800,364300,165500,24718,3.19248e+09,4.02942e+09,6.98754e+06
19971022,529000,355300,173700,71328,3.20217e+09,3.98605e+09,6.44575e+06
19971023,532300,320700,211600,-74279,3.1895e+09,3.94693e+09,5.29414e+06
19971024,532100,316800,215300,43848,3.19985e+09,3.92141e+09,4.97816e+06
19971027,539900,230600,309300,95824,3.2173e+09,3.73192e+09,197155
19971028,542800,173700,369100,-174751,3.19044e+09,3.86906e+09,-4.3637e+06
19971029,543100,136700,406400,-51732,3.18373e+09,3.8898e+09,-7.63817e+06
19971030,543700,106500,437200,228747,3.22147e+09,3.82453e+09,-1.04498e+07
19971031,543400,96900,446500,-124660,3.2008e+09,3.86081e+09,-1.14264e+07
19971103,542600,117400,425200,-173638,3.17109e+09,3.93283e+09,-9.81876e+06
19971104,542700,149700,393000,-46554,3.16141e+09,3.94922e+09,-7.06346e+06
19971105,540700,181500,359200,-56118,3.15109e+09,3.9531e+09,-4.7216e+06
19971106,540700,224200,316500,56682,3.15782e+09,3.93533e+09,-592561
19971107,540100,254200,285900,12227,3.15565e+09,3.87277e+09,1.74643e+06
19971110,539200,301800,237400,19827,3.15416e+09,3.8504e+09,3.09741e+06
19971111,535800,294600,241200,66414,3.1639e+09,3.82857e+09,2.88893e+06
19971112,539800,287700,252100,39072,3.16939e+09,3.81008e+09,2.26956e+06
19971113,540900,271100,269800,49354,3.17908e+09,3.83869e+09,779527
19971114,540700,266900,273800,-26574,3.17271e+09,3.88909e+09,400470
19971117,539000,277400,261600,-46178,3.16357e+09,3.94247e+09,1.24075e+06
19971118,538600,287000,251600,38172,3.1696e+09,3.90759e+09,2.29374e+06
19971119,536200,312300,223900,80059,3.176e+09,3.87704e+09,4.82567e+06
19971120,535800,346100,189700,123555,3.1974e+09,3.93923e+09,8.15363e+06
19971121,534000,389300,144700,59770,3.20743e+09,3.93466e+09,1.08789e+07
19971124,535300,381400,153900,-82977,3.19272e+09,3.86172e+09,1.03788e+07
19971125,535800,375700,160100,29081,3.19855e+09,3.85012e+09,1.00594e+07
19971126,535200,373900,161300,29526,3.20374e+09,3.85577e+09,1.01669e+07
19971128,536300,369100,167200,-1537,3.20183e+09,3.87519e+09,9.8441e+06
19971201,536800,365800,171000,254100,3.23974e+09,3.94856e+09,9.88663e+06
19971202,535700,373900,161800,6580,3.24006e+09,3.93427e+09,1.05787e+07
19971203,535700,384900,150800,45341,3.24913e+09,3.94223e+09,1.15471e+07
19971204,535900,392100,143800,-6379,3.24886e+09,3.9376e+09,1.23896e+07
19971205,535700,398200,137500,64923,3.26065e+09,3.96269e+09,1.28132e+07
19971208,540000,383700,156300,3218,3.26082e+09,4.00501e+09,1.36451e+07
19971209,542000,385200,156800,-32720,3.25472e+09,3.9863e+09,1.35552e+07
19971210,542200,384000,158200,-31564,3.25137e+09,3.95561e+09,1.31381e+07
19971211,543500,374700,168800,-109348,3.23509e+09,3.90321e+09,1.20841e+07
19971212,545600,340900,204700,28956,3.24029e+09,3.91241e+09,9.73987e+06
19971215,548200,308200,240000,73270,3.25168e+09,3.96109e+09,6.89355e+06
19971216,549200,283100,266100,-9525,3.24697e+09,3.97705e+09,4.97385e+06
19971217,550100,285200,264900,76357,3.26219e+09,3.97049e+09,5.03126e+06
19971218,551300,272400,278900,14379,3.25978e+09,3.94006e+09,3.83615e+06
19971219,554300,257100,297200,-78756,3.24826e+09,3.92868e+09,2.61856e+06
19971222,555400,250100,305300,6069,3.24788e+09,3.95714e+09,1.81883e+06
19971223,556100,252300,303800,80789,3.26207e+09,3.92026e+09,1.32636e+06
19971224,557600,224900,332700,-19598,3.25992e+09,3.91069e+09,-1.30666e+06
19971226,557900,231600,326300,3733,3.26023e+09,3.91727e+09,-1.07221e+06
19971229,557100,228700,328400,-27475,3.25382e+09,3.97431e+09,-1.48716e+06
19971230,557200,238900,318300,-203219,3.23207e+09,4.01916e+09,-868342
19971231,559100,267500,291600,-32950,3.22782e+09,4.05438e+09,1.561e+06
19980102,558500,324000,234500,-30407,3.22041e+09,4.03928e+09,6.21312e+06
19980105,555700,379600,176100,-56156,3.21597e+09,4.00685e+09,1.04243e+07
19980106,557000,441700,115300,-100873,3.20364e+09,3.95935e+09,1.3087e+07
19980107,570900,491900,79000,-69080,3.19132e+09,4.0208e+09,1.35971e+07
19980108,575800,482100,93700,-44764,3.18728e+09,4.04191e+09,1.30635e+07
19980109,579500,448800,130700,-274552,3.14347e+09,3.93936e+09,1.01528e+07
19980112,594800,373800,221000,62141,3.1523e+09,4.04755e+09,6.50904e+06
19980113,596200,338100,258100,-77,3.15007e+09,4.11722e+09,4.30756e+06
19980114,597100,318400,278700,-13834,3.1475e+09,4.14822e+09,2.38601e+06
19980115,595800,280200,315600,643,3.14941e+09,4.12841e+09,2.13812e+06
19980116,594300,286900,307400,-6370,3.15059e+09,4.13929e+09,2.82349e+06
19980120,593300,364200,229100,133157,3.17367e+09,4.19945e+09,6.24054e+06
19980121,583200,363000,220200,-40007,3.16921e+09,4.10786e+09,7.09787e+06
19980122,582000,405800,176200,-59687,3.16211e+09,4.0674e+09,7.47176e+06
19980123,581700,412600,169100,-35799,3.15409e+09,4.04268e+09,7.94674e+06
19980126,583500,398000,185500,-10959,3.14987e+09,4.05464e+09,6.89743e+06
19980127,584100,369000,215100,69846,3.16068e+09,4.09658e+09,4.75341e+06
19980128,583800,370700,213100,30627,3.16055e+09,4.14106e+09,4.91635e+06
19980129,583000,379200,203800,7256,3.1651e+09,4.15902e+09,5.73923e+06
19980130,582800,401700,181100,-11818,3.16191e+09,4.15232e+09,7.49772e+06
19980202,577100,403400,173700,197789,3.19299e+09,4.20992e+09,1.09006e+07
19980203,575200,414000,161200,88234,3.20805e+09,4.22413e+09,1.21444e+07
19980204,573600,430000,143600,91483,3.22275e+09,4.22345e+09,1.31492e+07
19980205,572300,474700,97600,-36850,3.216e+09,4.20618e+09,1.42882e+07
19980206,571800,487500,84300,129727,3.23527e+09,4.23541e+09,1.50026e+07
19980209,572000,505700,66300,6497,3.23684e+09,4.2321e+09,1.62872e+07
19980210,570700,504300,66400,118579,3.25689e+09,4.25636e+09,1.63012e+07
19980211,571300,515900,55400,11773,3.2572e+09,4.27011e+09,1.70397e+07
19980212,571700,522700,49000,66643,3.26842e+09,4.28471e+09,1.75656e+07
19980213,572300,524100,48200,-37525,3.26307e+09,4.27989e+09,1.76723e+07
19980217,572200,526600,45600,46468,3.27107e+09,4.289e+09,1.76974e+07
19980218,572600,525100,47500,126699,3.29333e+09,4.32064e+09,1.74621e+07
19980219,575100,494000,81100,-46230,3.28567e+09,4.32781e+09,1.71637e+07
19980220,574300,484200,90100,36942,3.29067e+09,4.33779e+09,1.6573e+07
19980223,574900,471300,103600,448,3.29374e+09,4.32259e+09,1.5978e+07
19980224,575200,472300,102900,-116645,3.27494e+09,4.29335e+09,1.55238e+07
19980225,574500,457100,117400,189339,3.30243e+09,4.34239e+09,1.462e+07
19980226,574500,450200,124300,120032,3.32319e+09,4.37495e+09,1.43901e+07
19980227,576600,455300,121300,8728,3.32371e+09,4.39135e+09,1.4714e+07
19980302,576000,450500,125500,-4986,3.32374e+09,4.38386e+09,1.44493e+07
19980303,575500,466100,109400,60675,3.33633e+09,4.3969e+09,1.52762e+07
19980304,576100,471500,104600,-34969,3.33168e+09,4.37905e+09,1.57199e+07
19980305,574400,458600,115800,-99329,3.31353e+09,4.3301e+09,1.43146e+07
19980306,574300,452700,121600,206906,3.34779e+09,4.39861e+09,1.4069e+07
19980309,574100,454500,119600,-31542,3.34038e+09,4.37826e+09,1.4178e+07
19980310,573100,446000,127100,140103,3.3641e+09,4.41561e+09,1.37947e+07
19980311,570800,452500,118300,69622,3.37394e+09,4.42076e+09,1.43966e+07
19980312,570200,460900,109300,42006,3.38445e+09,4.43232e+09,1.51944e+07
19980313,574600,471900,102700,5596,3.38527e+09,4.44471e+09,1.57394e+07
19980316,573600,491800,81800,154272,3.40777e+09,4.47946e+09,1.66007e+07
19980317,571600,489100,82500,787,3.41074e+09,4.43686e+09,1.64352e+07
19980318,571000,511700,59300,40377,3.4201e+09,4.4403e+09,1.65832e+07
19980319,570900,506700,64200,37737,3.42652e+09,4.45522e+09,1.63856e+07
19980320,570200,500500,69700,66216,3.43159e+09,4.46359e+09,1.60447e+07
19980323,568900,500400,68500,-50105,3.4275e+09,4.43389e+09,1.61233e+07
19980324,568800,472400,96400,122727,3.44801e+09,4.45905e+09,1.63436e+07
19980325,568100,479000,89100,-23026,3.4401e+09,4.467e+09,1.65612e+07
19980326,571000,511900,59100,13027,3.44228e+09,4.51386e+09,1.68505e+07
19980327,570500,504300,66200,-80855,3.4269e+09,4.48937e+09,1.65169e+07
19980330,569100,497800,71300,-38831,3.42226e+09,4.4613e+09,1.59449e+07
19980331,568100,492700,75400,165622,3.44705e+09,4.49967e+09,1.57183e+07
19980401,566600,480000,86600,88137,3.45949e+09,4.52038e+09,1.47819e+07
19980402,566100,451100,115000,69091,3.47171e+09,4.55095e+09,1.45785e+07
19980403,564600,458000,106600,-32555,3.46552e+09,4.53025e+09,1.51283e+07
19980406,563500,487700,75800,-108569,3.45044e+09,4.50338e+09,1.52101e+07
19980407,561600,478800,82800,-151838,3.42817e+09,4.45195e+09,1.42732e+07
19980408,558600,473600,85000,-83741,3.41195e+09,4.40652e+09,1.34347e+07
19980409,558000,463500,94500,111966,3.42943e+09,4.43327e+09,1.29415e+07
19980413,559400,444300,115100,-8573,3.42526e+09,4.44828e+09,1.12573e+07
19980414,559000,436200,122800,89447,3.43973e+09,4.48806e+09,1.05733e+07
19980415,557100,440400,116700,78054,3.45151e+09,4.49353e+09,1.10731e+07
19980416,556600,421500,135100,-104777,3.43445e+09,4.446e+09,9.72646e+06
19980417,554300,419400,134900,62500,3.44158e+09,4.46715e+09,1.01014e+07
19980420,552600,429000,123600,21741,3.44588e+09,4.4426e+09,1.08192e+07
19980421,551600,428500,123100,93845,3.46179e+09,4.45167e+09,1.10194e+07
19980422,538900,383900,155000,34904,3.46822e+09,4.38166e+09,1.02667e+07
19980423,537400,378300,159100,-141207,3.44559e+09,4.3101e+09,9.82626e+06
19980424,536200,348800,187400,-67044,3.43024e+09,4.25935e+09,7.13202e+06
19980427,535500,335600,199900,-176007,3.39999e+09,4.15688e+09,4.22385e+06
19980428,537400,299900,237500,86026,3.41145e+09,4.16959e+09,1.16682e+06
19980429,534700,251700,283000,28966,3.41841e+09,4.1944e+09,-2.01797e+06
19980430,534300,235900,298400,-100993,3.40367e+09,4.25456e+09,-3.56064e+06
19980501,533800,243000,290800,-78428,3.40193e+09,4.2377e+09,-2.89275e+06
19980504,531400,283700,247700,31285,3.40418e+09,4.22958e+09,-72876
19980505,530800,327100,203700,8017,3.40449e+09,4.20525e+09,3.56491e+06
19980506,529900,347800,182100,-16216,3.40081e+09,4.16399e+09,5.23176e+06
19980507,529100,334500,194600,-40537,3.39408e+09,4.11099e+09,4.48809e+06
19980508,529600,323100,206500,59972,3.40345e+09,4.15497e+09,3.84515e+06
19980511,529400,316000,213400,-45825,3.39737e+09,4.13203e+09,3.54104e+06
19980512,529300,321900,207400,-7605,3.39858e+09,4.13035e+09,4.1459e+06
19980513,529500,324700,204800,32659,3.40403e+09,4.13594e+09,4.65775e+06
19980514,529900,323500,206400,15762,3.40924e+09,4.12986e+09,4.77456e+06
19980515,530300,321800,208500,16191,3.41232e+09,4.09369e+09,4.7406e+06
19980518,530600,322400,208200,-84511,3.3898e+09,4.05987e+09,5.14155e+06
19980519,530400,319100,211300,69785,3.39354e+09,4.04071e+09,4.94524e+06
19980520,526000,279300,246700,49600,3.40244e+09,4.0249e+09,4.36445e+06
19980521,526900,268300,258600,17655,3.40353e+09,4.02611e+09,3.45552e+06
19980522,527400,267200,260200,-24070,3.40404e+09,4.00851e+09,3.43275e+06
19980526,528700,255700,273000,-48259,3.40019e+09,3.95208e+09,2.56802e+06
19980527,530400,226700,303700,23835,3.40692e+09,3.93724e+09,584438
19980528,530700,205000,325700,-4608,3.40335e+09,3.96628e+09,-1.30751e+06
19980529,532000,195100,336900,26468,3.40476e+09,3.97122e+09,-2.22025e+06
19980601,532800,192700,340100,193327,3.43578e+09,3.96751e+09,-2.9166e+06
19980602,532800,213900,318900,24196,3.4461e+09,3.93685e+09,-1.51483e+06
19980603,534200,231800,302400,310,3.44542e+09,3.91759e+09,-489373
19980604,533800,236300,297500,-59831,3.43716e+09,3.94135e+09,-26955
19980605,533800,245400,288400,39796,3.44365e+09,3.98683e+09,685159
19980608,533400,266800,266600,16045,3.44562e+09,3.99236e+09,2.00175e+06
19980609,533400,282300,251100,-13924,3.4407e+09,4.00563e+09,3.66974e+06
19980610,533700,292100,241600,65857,3.4485e+09,3.97434e+09,4.58521e+06
19980611,534400,299700,234700,14343,3.45246e+09,3.92551e+09,4.9536e+06
19980612,536200,294000,242200,23018,3.45762e+09,3.93956e+09,4.42977e+06
19980615,534100,251900,282200,-6087,3.45042e+09,3.82789e+09,2.02552e+06
19980616,538900,225200,313700,-130602,3.42298e+09,3.88884e+09,-459774
19980617,539600,215700,323900,20539,3.43032e+09,3.95243e+09,-908869
19980618,539900,213300,326600,43661,3.43811e+09,3.94506e+09,-850584
19980619,541300,235300,306000,-712,3.44078e+09,3.9329e+09,316156
19980622,541500,260900,280600,54284,3.44983e+09,3.95564e+09,1.96662e+06
19980623,541500,306800,234700,65329,3.46651e+09,3.9896e+09,3.56115e+06
19980624,538800,322200,216600,94352,3.48349e+09,4.01638e+09,4.76276e+06
19980625,540800,350800,190000,-14343,3.47919e+09,4.03736e+09,6.1286e+06
19980626,540600,370000,170600,14280,3.48365e+09,4.04632e+09,7.62226e+06
19980629,539600,381300,158300,44702,3.49069e+09,4.0426e+09,8.64025e+06
19980630,540000,390400,149600,8119,3.48787e+09,4.00352e+09,9.02151e+06
19980701,540400,410600,129800,128348,3.51292e+09,4.0453e+09,1.02328e+07
19980702,543800,408200,135600,-64859,3.49851e+09,4.04783e+09,1.05649e+07
19980706,543400,424700,118700,89438,3.51768e+09,4.06881e+09,1.22113e+07
19980707,543900,432900,111000,-16331,3.51351e+09,4.06498e+09,1.26696e+07
19980708,545900,442000,103900,81591,3.52752e+09,4.09461e+09,1.33676e+07
19980709,545100,440400,104700,-17241,3.52387e+09,4.07231e+09,1.31407e+07
19980710,545100,438200,106900,74840,3.52876e+09,4.04324e+09,1.30902e+07
19980713,547500,423500,124000,6888,3.53329e+09,4.04721e+09,1.23113e+07
19980714,549900,417400,132500,60674,3.5438e+09,4.08632e+09,1.19596e+07
19980715,552200,388400,163800,9051,3.54449e+09,4.10906e+09,1.0078e+07
19980716,554700,381800,172900,69736,3.55549e+09,4.14483e+09,9.74193e+06
19980717,559500,384900,174600,20997,3.56388e+09,4.19233e+09,9.69498e+06
19980720,561100,381100,180000,-11869,3.56424e+09,4.18165e+09,9.71997e+06
19980721,561400,379700,181700,-104093,3.54531e+09,4.12587e+09,9.40498e+06
19980722,562200,375200,187000,8779,3.54823e+09,4.12219e+09,8.67248e+06
19980723,561800,349800,212000,-139733,3.52106e+09,4.03773e+09,6.77205e+06
19980724,564200,305700,258500,-4464,3.52252e+09,4.03564e+09,2.72746e+06
19980727,568500,259500,309000,50504,3.52795e+09,4.05512e+09,-522185
19980728,572400,229900,342500,59451,3.53544e+09,4.03292e+09,-3.61766e+06
19980729,572500,204400,368100,28830,3.53852e+09,4.0281e+09,-5.88667e+06
19980730,574600,189500,385100,-67841,3.53022e+09,4.09468e+09,-6.65434e+06
19980731,574500,172800,401700,159179,3.55361e+09,4.02054e+09,-7.6354e+06
19980803,574900,135400,439500,66544,3.55993e+09,3.99107e+09,-8.52279e+06
19980804,575800,118300,457500,288545,3.60187e+09,3.87397e+09,-9.81479e+06
19980805,576400,114000,462400,35611,3.60761e+09,3.88953e+09,-1.03986e+07
19980806,578600,94400,484200,-81093,3.5936e+09,3.93619e+09,-1.17312e+07
19980807,578900,99800,479100,-123411,3.57276e+09,3.97424e+09,-1.17984e+07
19980810,580600,102500,478100,124987,3.59376e+09,3.96104e+09,-1.17364e+07
19980811,581800,121900,459900,198474,3.62615e+09,3.89991e+09,-1.06647e+07
19980812,581200,138200,443000,-128880,3.60287e+09,3.95913e+09,-9.51009e+06
19980813,581500,160100,421400,68457,3.61404e+09,3.92965e+09,-7.3566e+06
19980814,581900,172200,409700,134896,3.62701e+09,3.87211e+09,-6.53088e+06
19980817,582100,190600,391500,-27267,3.61882e+09,3.91401e+09,-5.26134e+06
19980818,581800,222900,358900,-84870,3.61104e+09,3.97493e+09,-3.12949e+06
19980819,583700,251500,332200,-17988,3.61126e+09,3.9647e+09,-1.27363e+06
19980820,584600,274100,310500,52612,3.61751e+09,3.94907e+09,642566
19980821,587500,276000,311500,73976,3.62028e+09,3.91886e+09,1.0021e+06
19980824,587300,294300,293000,42363,3.62672e+09,3.9311e+09,2.0196e+06
19980825,587600,286700,300900,14056,3.62825e+09,3.95254e+09,2.21656e+06
19980826,586600,258800,327800,75305,3.63636e+09,3.8872e+09,1.72173e+06
19980827,592900,232500,360400,134409,3.64881e+09,3.7822e+09,355405
19980828,601300,185200,416100,118698,3.66506e+09,3.78755e+09,-2.49933e+06
19980831,611700,130800,480900,635550,3.77884e+09,3.63698e+09,-6.70769e+06
19980901,616300,95300,521000,-397866,3.70687e+09,3.76867e+09,-1.0053e+07
19980902,618700,71800,546900,-114903,3.68846e+09,3.78602e+09,-1.23827e+07
19980903,619000,65800,553200,138588,3.71132e+09,3.75147e+09,-1.27505e+07
19980904,620500,60200,560300,11541,3.71342e+09,3.7414e+09,-1.31833e+07
19980908,623600,98500,525100,-613464,3.60792e+09,3.93488e+09,-1.18122e+07
19980909,624600,123300,501300,195149,3.64401e+09,3.87558e+09,-1.00265e+07
19980910,626000,144100,481900,382769,3.70867e+09,3.78699e+09,-8.30734e+06
19980911,629500,179900,449600,-133819,3.69031e+09,3.88053e+09,-6.28485e+06
19980914,628900,221200,407700,-105930,3.67657e+09,3.95776e+09,-3.81755e+06
19980915,636700,245700,391000,7947,3.67498e+09,4.04545e+09,-2.35116e+06
19980916,637100,282500,354600,6739,3.67308e+09,4.07064e+09,-357536
19980917,639900,349700,290200,-40325,3.66232e+09,4.0037e+09,3.64456e+06
19980918,642100,370500,271600,65437,3.67301e+09,4.04145e+09,5.56154e+06
19980921,643700,397300,246400,42384,3.67786e+09,4.03664e+09,7.03327e+06
19980922,646000,423600,222400,64072,3.68853e+09,4.0818e+09,8.8166e+06
19980923,656400,479500,176900,280228,3.73535e+09,4.26728e+09,1.02548e+07
19980924,655400,503900,151500,-228483,3.69749e+09,4.18358e+09,1.1694e+07
19980925,657300,503100,154200,43230,3.70521e+09,4.18973e+09,1.16323e+07
19980928,658600,539200,119400,33584,3.71195e+09,4.21387e+09,1.31578e+07
19980929,660400,529300,131100,43890,3.72031e+09,4.21548e+09,1.26524e+07
19980930,663800,504900,158900,-226555,3.67792e+09,4.14037e+09,1.11039e+07
19981001,669000,470000,199000,-283251,3.62541e+09,4.03756e+09,9.0325e+06
19981002,673300,422600,250700,140871,3.651e+09,4.14933e+09,6.31089e+06
19981005,680800,373000,307800,67886,3.65514e+09,4.12805e+09,3.35987e+06
19981006,689900,316400,373500,11815,3.66066e+09,4.17224e+09,-843693
19981007,695300,264900,430400,176501,3.68813e+09,4.14727e+09,-3.16246e+06
19981008,699500,231000,468500,242494,3.72674e+09,4.09282e+09,-4.9266e+06
19981009,701800,205700,496100,-474083,3.65318e+09,4.2085e+09,-6.75964e+06
19981012,701900,211800,490100,-386920,3.58503e+09,4.283e+09,-6.71202e+06
19981013,703600,208900,494700,76720,3.59688e+09,4.28329e+09,-6.53876e+06
19981014,704000,233800,470200,-137526,3.57606e+09,4.34903e+09,-4.51742e+06
19981015,698800,271900,426900,-96569,3.55938e+09,4.48697e+09,-962539
19981016,694800,346600,348200,-32601,3.55833e+09,4.52879e+09,4.17804e+06
19981019,689800,413700,276100,22287,3.55895e+09,4.55804e+09,7.87145e+06
19981020,683900,483900,200000,44556,3.56314e+09,4.54062e+09,1.12382e+07
19981021,679900,545600,134300,-6522,3.56029e+09,4.50453e+09,1.47046e+07
19981022,674100,561300,112800,168008,3.58917e+09,4.51144e+09,1.5153e+07
19981023,673000,568400,104600,-121978,3.56956e+09,4.45735e+09,1.48274e+07
19981026,671500,568100,103400,169554,3.59707e+09,4.47789e+09,1.4893e+07
19981027,671800,569700,102100,-37359,3.59314e+09,4.47123e+09,1.46475e+07
19981028,671600,578800,92800,15449,3.59859e+09,4.47549e+09,1.44517e+07
19981029,668800,577600,91200,249755,3.63717e+09,4.50423e+09,1.44566e+07
19981030,669100,569800,99300,237724,3.67264e+09,4.57902e+09,1.43477e+07
19981102,669200,572700,96500,248366,3.70402e+09,4.64532e+09,1.48602e+07
19981103,668700,579900,88800,-54209,3.69363e+09,4.63026e+09,1.5396e+07
19981104,668900,595400,73500,273263,3.74016e+09,4.69046e+09,1.68054e+07
19981105,667300,610900,56400,172279,3.77001e+09,4.72813e+09,1.81501e+07
19981106,666700,620100,46600,130685,3.78805e+09,4.75796e+09,1.88773e+07
19981109,666800,615100,51700,-141669,3.76432e+09,4.72575e+09,1.83767e+07
19981110,666800,625300,41500,-87442,3.75376e+09,4.70995e+09,1.85453e+07
19981111,667800,612700,55100,-158762,3.7267e+09,4.67563e+09,1.76672e+07
19981112,672900,569600,103300,66273,3.74084e+09,4.72203e+09,1.69187e+07
19981113,673500,545100,128400,37116,3.74734e+09,4.73704e+09,1.6371e+07
19981116,673500,529400,144100,52919,3.75459e+09,4.7644e+09,1.59192e+07
19981117,671900,509200,162700,49874,3.76186e+09,4.77031e+09,1.52316e+07
19981118,671300,516000,155300,48008,3.77502e+09,4.74255e+09,1.57663e+07
19981119,668500,516500,152000,89812,3.78801e+09,4.73733e+09,1.63147e+07
19981120,666700,501900,164800,112012,3.8075e+09,4.75779e+09,1.58843e+07
19981123,665200,501200,164000,403005,3.88188e+09,4.84042e+09,1.59132e+07
19981124,663000,499600,163400,-55275,3.8699e+09,4.79762e+09,1.60648e+07
19981125,660100,489300,170800,42684,3.87431e+09,4.78421e+09,1.5657e+07
19981127,655900,461800,194100,44852,3.88191e+09,4.77358e+09,1.48162e+07
19981130,655300,461600,193700,-272448,3.83123e+09,4.66573e+09,1.42639e+07
19981201,652900,447900,205000,112947,3.84139e+09,4.67067e+09,1.36e+07
19981202,652100,430800,221300,29719,3.85185e+09,4.64257e+09,1.25279e+07
19981203,651900,416800,235100,-96536,3.82974e+09,4.57376e+09,1.09746e+07
19981204,648200,405800,242400,188836,3.86092e+09,4.62536e+09,9.98226e+06
19981207,645400,403100,242300,65942,3.86988e+09,4.63874e+09,1.01989e+07
19981208,647300,380600,266700,60066,3.87872e+09,4.64936e+09,9.2581e+06
19981209,645700,371000,274700,-6165,3.88193e+09,4.61904e+09,8.33204e+06
19981210,645900,365800,280100,-135931,3.86137e+09,4.54213e+09,8.16283e+06
19981211,646400,343400,303000,33068,3.87308e+09,4.53239e+09,6.27612e+06
19981214,645900,310200,335700,-113688,3.85384e+09,4.45239e+09,3.15238e+06
19981215,643500,280100,363400,28551,3.85583e+09,4.47463e+09,827699
19981216,641600,248300,393300,113945,3.88598e+09,4.47243e+09,-1.35254e+06
19981217,641200,246600,394600,-25881,3.87979e+09,4.54325e+09,-1.78426e+06
19981218,642300,259500,382800,106610,3.89798e+09,4.58684e+09,-658321
19981221,640300,289900,350400,179350,3.93875e+09,4.63696e+09,2.01499e+06
19981222,639200,309000,330200,1501,3.93821e+09,4.61107e+09,4.06319e+06
19981223,634900,333900,301000,104860,3.9507e+09,4.65725e+09,5.85961e+06
19981224,633800,396300,237500,-8642,3.94527e+09,4.65623e+09,7.74336e+06
19981228,632300,408400,223900,74379,3.96695e+09,4.66689e+09,8.63462e+06
19981229,631200,438900,192300,130538,3.98605e+09,4.70048e+09,1.07328e+07
19981230,629200,474500,154700,-76672,3.96931e+09,4.67876e+09,1.26228e+07
19981231,624000,487300,136700,87087,3.99165e+09,4.6744e+09,1.37686e+07
19990104,623600,506500,117100,-35016,3.98331e+09,4.64015e+09,1.51173e+07
19990105,624100,545800,78300,-37802,3.95219e+09,4.67867e+09,1.6724e+07
19990106,623700,582500,41200,430783,4.0278e+09,4.7605e+09,1.8522e+07
19990107,624800,598500,26300,-3724,4.03091e+09,4.75502e+09,1.91994e+07
19990108,630400,601400,29000,110386,4.04784e+09,4.79457e+09,1.92032e+07
19990111,630000,594400,35600,-31389,4.04674e+09,4.77317e+09,1.85094e+07
19990112,631300,583200,48100,-350246,3.98966e+09,4.69665e+09,1.7252e+07
19990113,632200,562700,69500,-162647,3.96005e+09,4.66412e+09,1.5171e+07
19990114,634800,515000,119800,-169977,3.93004e+09,4.61106e+09,1.21793e+07
19990115,636000,486600,149400,249922,3.97156e+09,4.71408e+09,1.00982e+07
19990119,636900,461900,175000,184122,4.0009e+09,4.74999e+09,8.04217e+06
19990120,636500,436500,200000,21932,4.00517e+09,4.73662e+09,5.89272e+06
19990121,641500,381800,259700,-98871,3.98743e+09,4.69942e+09,4.01392e+06
19990122,642000,377000,265000,-25096,3.98257e+09,4.67362e+09,3.39253e+06
19990125,644000,349600,294400,35837,3.99123e+09,4.70448e+09,1.99608e+06
19990126,643700,317500,326200,69552,3.99678e+09,4.74928e+09,597702
19990127,644900,296400,348500,85491,4.00824e+09,4.74302e+09,-258677
19990128,642900,289000,353900,135410,4.03066e+09,4.78609e+09,503126
19990129,640900,285500,355400,155037,4.0582e+09,4.8089e+09,678637
19990201,641000,296500,344500,-109110,4.0389e+09,4.78108e+09,1.88834e+06
19990202,640900,293900,347000,-47065,4.02998e+09,4.74649e+09,1.83429e+06
19990203,640300,296600,343700,74101,4.03931e+09,4.79539e+09,2.49943e+06
19990204,638700,295000,343700,-103592,4.02676e+09,4.71465e+09,2.32379e+06
19990205,638700,293400,345300,-119339,4.00689e+09,4.68261e+09,1.89589e+06
19990208,639000,298600,340400,-13830,4.00358e+09,4.69505e+09,2.06591e+06
19990209,637000,321300,315700,-85710,3.99147e+09,4.5922e+09,2.64577e+06
19990210,636100,325700,310400,-1369,3.98875e+09,4.58741e+09,1.60431e+06
19990211,633800,325700,308100,89186,3.99313e+09,4.68081e+09,1.77902e+06
19990212,635400,299200,336200,52572,4.00792e+09,4.62038e+09,858433
19990216,634700,283700,351000,64980,4.02193e+09,4.6392e+09,3814
19990217,635700,282400,353300,-20033,4.02137e+09,4.56331e+09,325532
19990218,635800,273400,362400,61548,4.03334e+09,4.60051e+09,261847
19990219,638000,264400,373600,-12180,4.03197e+09,4.63765e+09,-348780
19990222,635600,267200,368400,37067,4.03556e+09,4.74794e+09,406936
19990223,634500,278500,356000,-40502,4.03522e+09,4.69001e+09,2.18757e+06
19990224,634300,299400,334900,-80493,4.02304e+09,4.5979e+09,3.8768e+06
19990225,633600,304700,328900,-26938,4.02094e+09,4.55098e+09,4.52114e+06
19990226,633900,316000,317900,47144,4.02928e+09,4.55227e+09,5.14413e+06
19990301,627600,274700,352900,-92536,4.00448e+09,4.49649e+09,3.9711e+06
19990302,628600,262500,366100,-14847,3.99877e+09,4.45907e+09,3.35844e+06
19990303,629000,257400,371600,-25762,3.99542e+09,4.46128e+09,2.72348e+06
19990304,629400,259500,369900,68582,4.00505e+09,4.52794e+09,3.51308e+06
19990305,628500,290700,337800,108618,4.02332e+09,4.62519e+09,5.36569e+06
19990308,634200,343700,290500,2416,4.02255e+09,4.65509e+09,7.74386e+06
19990309,633800,364200,269600,5154,4.02596e+09,4.63325e+09,9.13564e+06
19990310,632800,414300,218500,135097,4.04941e+09,4.65945e+09,1.09888e+07
19990311,637600,427400,210200,57952,4.06482e+09,4.629e+09,1.1428e+07
19990312,639900,440500,199400,-40660,4.06126e+09,4.60088e+09,1.17278e+07
19990315,641700,453200,188500,80305,4.07292e+09,4.65591e+09,1.20986e+07
19990316,642400,450000,192400,-83615,4.05783e+09,4.65164e+09,1.19058e+07
19990317,645400,462900,182500,-18571,4.05427e+09,4.67666e+09,1.24048e+07
19990318,645700,461400,184300,174532,4.08476e+09,4.72554e+09,1.22941e+07
19990319,646500,460200,186300,-96222,4.06541e+09,4.67943e+09,1.19588e+07
19990322,650100,445800,204300,-25223,4.06381e+09,4.6721e+09,1.13947e+07
19990323,651700,428100,223600,-215266,4.03346e+09,4.57237e+09,9.56718e+06
19990324,655100,409400,245700,60285,4.04129e+09,4.62619e+09,8.02322e+06
19990325,657000,385100,271900,148389,4.07198e+09,4.72661e+09,6.412e+06
19990326,658100,345900,312200,88460,4.08854e+09,4.70278e+09,3.96548e+06
19990329,658700,327400,331300,-8025,4.09045e+09,4.7633e+09,2.54745e+06
19990330,659800,375500,284300,12806,4.0896e+09,4.73416e+09,4.06906e+06
19990331,662500,357000,305500,6530,4.09257e+09,4.75233e+09,2.86619e+06
19990401,663400,358000,305400,-25025,4.08199e+09,4.77997e+09,2.78988e+06
19990405,661800,368500,293300,129709,4.11031e+09,4.84186e+09,3.67246e+06
19990406,664000,368200,295800,160,4.1103e+09,4.82634e+09,3.90002e+06
19990407,666700,374000,292700,3085,4.11483e+09,4.82197e+09,4.15624e+06
19990408,664700,380100,284600,76877,4.12547e+09,4.85971e+09,5.60758e+06
19990409,662200,378500,283700,47769,4.13393e+09,4.86555e+09,7.32975e+06
19990412,661300,359900,301400,81081,4.14944e+09,4.90687e+09,6.81961e+06
19990413,659800,384100,275700,40420,4.15593e+09,4.89428e+09,8.21842e+06
19990414,658700,404000,254700,-34489,4.15365e+09,4.8692e+09,9.36199e+06
19990415,656000,438500,217500,100404,4.17109e+09,4.87657e+09,1.06079e+07
19990416,650700,473800,176900,125195,4.19205e+09,4.86061e+09,1.15289e+07
19990419,650800,474400,176400,108625,4.21243e+09,4.79355e+09,1.07204e+07
19990420,649200,504300,144900,-176696,4.18258e+09,4.79023e+09,1.04308e+07
19990421,642800,496100,146700,97873,4.1976e+09,4.88895e+09,1.03912e+07
19990422,642300,514400,127900,-17881,4.19208e+09,4.90827e+09,1.17178e+07
19990423,641100,519500,121600,-2058,4.19469e+09,4.88908e+09,1.2322e+07
19990426,641400,530200,111200,-5732,4.19436e+09,4.90429e+09,1.34728e+07
19990427,645100,567600,77500,174009,4.22793e+09,4.90318e+09,1.49277e+07
19990428,644100,570900,73200,155580,4.24819e+09,4.8516e+09,1.56324e+07
19990429,640300,565700,74600,148844,4.27627e+09,4.83522e+09,1.54955e+07
19990430,642500,564200,78300,-53998,4.26557e+09,4.84504e+09,1.47624e+07
19990503,642100,563600,78500,294927,4.30962e+09,4.91505e+09,1.42226e+07
19990504,643400,558800,84600,-7644,4.30722e+09,4.86062e+09,1.35175e+07
19990505,643400,551000,92400,35471,4.3124e+09,4.89494e+09,1.28339e+07
19990506,642900,542500,100400,-45696,4.30059e+09,4.8345e+09,1.21783e+07
19990507,643400,539600,103800,8895,4.30046e+09,4.86657e+09,1.19763e+07
19990510,642900,534100,108800,11668,4.30758e+09,4.85894e+09,1.13799e+07
19990511,642700,538100,104600,-70453,4.29812e+09,4.8667e+09,1.1669e+07
19990512,641600,531500,110100,-18778,4.29628e+09,4.87653e+09,1.11373e+07
19990513,640900,537400,103500,59041,4.30769e+09,4.89417e+09,1.21758e+07
19990514,641800,533400,108400,-218504,4.26737e+09,4.79911e+09,1.1591e+07
19990517,640100,523500,116600,-39432,4.26019e+09,4.78007e+09,1.16552e+07
19990518,638200,509600,128600,-46343,4.2554e+09,4.70517e+09,1.01003e+07
19990519,638500,479400,159100,95610,4.26857e+09,4.7437e+09,7.79627e+06
19990520,635100,450800,184300,22494,4.27092e+09,4.72083e+09,6.56794e+06
19990521,631700,439600,192100,29417,4.27561e+09,4.68851e+09,5.70328e+06
19990524,630400,407400,223000,24849,4.2821e+09,4.58092e+09,3.96514e+06
19990525,632500,389500,243000,8845,4.28187e+09,4.51653e+09,2.83423e+06
19990526,631100,402600,228500,-94415,4.27014e+09,4.543e+09,2.3987e+06
19990527,630400,360100,270300,7241,4.26929e+09,4.45752e+09,-377804
19990528,628500,324400,304100,-66719,4.26077e+09,4.49507e+09,-1.94737e+06
19990601,628800,315700,313100,53783,4.26975e+09,4.45844e+09,-2.59011e+06
19990602,628300,318500,309800,-2202,4.27636e+09,4.46255e+09,-2.01394e+06
19990603,627900,339200,288700,18698,4.28168e+09,4.46881e+09,-1.27783e+06
19990604,613200,369200,244000,-27924,4.2754e+09,4.42402e+09,1.17527e+06
19990607,610300,397400,212900,33869,4.28022e+09,4.4212e+09,3.53222e+06
19990608,609200,420000,189200,-49628,4.2743e+09,4.36271e+09,6.02466e+06
19990609,604700,416400,188300,27048,4.27574e+09,4.31803e+09,6.49375e+06
19990610,603500,441100,162400,-61262,4.26671e+09,4.27334e+09,8.08503e+06
19990611,604300,435600,168700,-44533,4.26469e+09,4.21334e+09,7.59915e+06
19990614,604800,417200,187600,63512,4.27655e+09,4.21479e+09,6.3352e+06
19990615,601900,393600,208300,57859,4.28763e+09,4.23567e+09,5.14046e+06
19990616,600900,395200,205700,16416,4.28931e+09,4.30765e+09,5.39664e+06
19990617,600000,406100,193900,51159,4.29835e+09,4.32146e+09,6.52985e+06
19990618,600500,412200,188300,47529,4.30562e+09,4.33721e+09,8.112e+06
19990621,601400,431000,170400,4962,4.30235e+09,4.34672e+09,1.00689e+07
19990622,603200,446200,157000,-179372,4.26665e+09,4.31532e+09,1.04321e+07
19990623,603600,444200,159400,-10588,4.26773e+09,4.31469e+09,1.01891e+07
19990624,603600,432200,171400,-150971,4.24251e+09,4.2667e+09,9.14468e+06
19990625,608700,389400,219300,54688,4.25254e+09,4.29398e+09,7.11571e+06
19990628,610200,349700,260500,96761,4.26722e+09,4.36404e+09,5.26876e+06
19990629,611700,339900,271800,140725,4.28562e+09,4.42879e+09,4.7696e+06
19990630,608800,338500,270300,127694,4.30806e+09,4.46785e+09,4.95212e+06
19990701,609700,357700,252000,-114776,4.29309e+09,4.4469e+09,6.21084e+06
19990702,609100,392300,216800,-8988,4.28904e+09,4.4535e+09,8.27614e+06
19990706,608200,401700,206500,23421,4.29478e+09,4.44596e+09,9.03311e+06
19990707,606500,423900,182600,35746,4.29588e+09,4.42488e+09,1.01684e+07
19990708,606900,421700,185200,77086,4.3089e+09,4.43439e+09,9.9826e+06
19990709,607800,417600,190200,57094,4.31633e+09,4.45836e+09,9.62417e+06
19990712,606900,406600,200300,-49350,4.30711e+09,4.43727e+09,9.1858e+06
19990713,606900,402700,204200,-66787,4.29957e+09,4.4141e+09,9.0392e+06
19990714,606900,393700,213200,75263,4.31763e+09,4.42918e+09,8.64156e+06
19990715,604100,380200,223900,100209,4.33366e+09,4.45341e+09,8.44369e+06
19990716,603600,382500,221100,42721,4.34214e+09,4.45241e+09,8.62456e+06
19990719,603900,395300,208600,-55895,4.33371e+09,4.4231e+09,8.80615e+06
19990720,604100,399700,204400,-275296,4.28793e+09,4.34929e+09,8.52476e+06
19990721,606900,403100,203800,-2433,4.28523e+09,4.36203e+09,8.42695e+06
19990722,611100,374400,236700,-165097,4.2646e+09,4.32181e+09,6.06119e+06
19990723,614800,343200,271600,42399,4.26981e+09,4.37404e+09,3.14573e+06
19990726,615300,303300,312000,-3668,4.26766e+09,4.34552e+09,248263
19990727,615900,297900,318000,29049,4.27379e+09,4.39018e+09,-113676
19990728,617300,286400,330900,-7841,4.26799e+09,4.39004e+09,-747235
19990729,619000,263900,355100,65806,4.27725e+09,4.32168e+09,-1.75182e+06
19990730,618000,265200,352800,71472,4.28747e+09,4.30678e+09,-2.07838e+06
19990802,618100,266600,351500,35130,4.29221e+09,4.2915e+09,-1.97255e+06
19990803,617800,264600,353200,127900,4.31284e+09,4.23666e+09,-3.1545e+06
19990804,616800,256000,360800,132044,4.33415e+09,4.17797e+09,-4.02882e+06
19990805,616900,251900,365000,-11696,4.33444e+09,4.19563e+09,-4.19118e+06
19990806,614500,232500,382000,108115,4.35287e+09,4.15289e+09,-4.36845e+06
19990809,615400,202500,412900,66167,4.3646e+09,4.15708e+09,-5.03182e+06
19990810,615300,180900,434400,65063,4.37214e+09,4.12582e+09,-5.94567e+06
19990811,614900,177800,437100,-36012,4.36799e+09,4.18481e+09,-6.22183e+06
19990812,614900,164000,450900,-31227,4.36059e+09,4.17961e+09,-7.2367e+06
19990813,615000,169600,445400,-173081,4.33178e+09,4.26386e+09,-6.91456e+06
19990816,614900,184100,430800,-25724,4.33004e+09,4.26717e+09,-5.21468e+06
19990817,614600,245400,369200,-50230,4.32462e+09,4.26907e+09,-950198
19990818,614300,268800,345500,-46372,4.31911e+09,4.24109e+09,1.55347e+06
19990819,613300,320600,292700,-10248,4.31405e+09,4.22409e+09,4.33045e+06
19990820,615200,338600,276600,129273,4.33848e+09,4.28735e+09,5.81934e+06
19990823,615100,360600,254500,168058,4.36596e+09,4.35254e+09,7.12086e+06
19990824,615300,377900,237400,26647,4.36694e+09,4.32808e+09,8.44096e+06
19990825,614500,386600,227900,79703,4.38042e+09,4.34663e+09,9.0489e+06
19990826,615200,410400,204800,-135378,4.35746e+09,4.31216e+09,1.01175e+07
19990827,616900,405400,211500,-81245,4.34572e+09,4.28448e+09,9.95776e+06
19990830,618100,390600,227500,-139629,4.31594e+09,4.21461e+09,9.10001e+06
19990831,622800,369800,253000,43829,4.32207e+09,4.25574e+09,7.19324e+06
19990901,625400,344300,281100,14503,4.3253e+09,4.28953e+09,5.75907e+06
19990902,627400,306400,321000,8841,4.3189e+09,4.25134e+09,3.13432e+06
19990903,628200,299500,328700,113130,4.3383e+09,4.35731e+09,2.50628e+06
19990907,628000,314900,313100,41995,4.34811e+09,4.34723e+09,3.01517e+06
19990908,629600,374100,255500,-6448,4.34949e+09,4.38403e+09,4.16359e+06
19990909,633700,387100,246600,54230,4.35962e+09,4.44194e+09,4.9766e+06
19990910,633500,386300,247200,54498,4.37148e+09,4.45326e+09,5.45451e+06
19990913,637700,371900,265800,-44665,4.35976e+09,4.41587e+09,4.71498e+06
19990914,636700,360800,275900,90944,4.37563e+09,4.40484e+09,3.83244e+06
19990915,640700,329100,311600,-70226,4.36123e+09,4.39393e+09,2.51382e+06
19990916,641800,310200,331600,22411,4.36153e+09,4.37891e+09,997822
19990917,642600,290900,351700,28290,4.36849e+09,4.42938e+09,342244
19990920,643400,280500,362900,54891,4.37505e+09,4.41219e+09,-921904
19990921,646100,261000,385100,22908,4.37349e+09,4.34305e+09,-1.95045e+06
19990922,648300,240600,407700,81801,4.38357e+09,4.36735e+09,-3.29056e+06
19990923,648800,224800,424000,63505,4.39112e+09,4.2743e+09,-3.85523e+06
19990924,652600,166000,486600,52722,4.4014e+09,4.29166e+09,-6.49623e+06
19990927,657000,155600,501400,26753,4.40862e+09,4.32198e+09,-7.5028e+06
19990928,657600,149500,508100,100483,4.42422e+09,4.31718e+09,-8.12537e+06
19990929,658900,133100,525800,-11666,4.4241e+09,4.32319e+09,-9.29982e+06
19990930,658800,159800,499000,-13713,4.42712e+09,4.34501e+09,-8.41172e+06
19991001,658600,164000,494600,71267,4.43653e+09,4.31133e+09,-8.35782e+06
19991004,659900,190400,469500,29265,4.44011e+09,4.39086e+09,-6.52114e+06
19991005,659300,243700,415600,74390,4.4559e+09,4.37534e+09,-4.48742e+06
19991006,657100,282400,374700,-38099,4.44782e+09,4.42471e+09,-1.33558e+06
19991007,656200,300400,355800,22428,4.45039e+09,4.39496e+09,498137
19991008,655900,331600,324300,127027,4.46723e+09,4.42759e+09,2.67638e+06
19991011,657100,363700,293400,-4363,4.46618e+09,4.45871e+09,4.77866e+06
19991012,658800,365600,293200,-67036,4.45391e+09,4.37526e+09,5.13765e+06
19991013,659600,360600,299000,-94366,4.44158e+09,4.29499e+09,4.61756e+06
19991014,660700,352700,308000,-7458,4.43871e+09,4.31931e+09,4.15249e+06
19991015,664600,319300,345300,-75290,4.43121e+09,4.24636e+09,1.73815e+06
19991018,670100,265700,404400,45119,4.43939e+09,4.2816e+09,-1.34706e+06
19991019,672600,230500,442100,89953,4.45344e+09,4.30898e+09,-3.4372e+06
19991020,671300,228000,443300,-22093,4.45212e+09,4.36124e+09,-3.73176e+06
19991021,672400,243200,429200,67991,4.46834e+09,4.37979e+09,-3.65342e+06
19991022,673300,235900,437400,1983,4.46525e+09,4.44494e+09,-3.05491e+06
19991025,671700,266700,405000,32800,4.47227e+09,4.41059e+09,-898287
19991026,675700,271900,403800,2513,4.47511e+09,4.3885e+09,-754064
19991027,674200,289800,384400,11904,4.47203e+09,4.41623e+09,335443
19991028,672800,332900,339900,116075,4.48873e+09,4.55136e+09,2.49325e+06
19991029,680500,366900,313600,70008,4.50086e+09,4.70979e+09,4.42527e+06
19991101,680000,389200,290800,25156,4.50388e+09,4.704e+09,6.70493e+06
19991102,682800,453800,229000,38898,4.50681e+09,4.72874e+09,9.65034e+06
19991103,680800,491300,189500,54758,4.51357e+09,4.74418e+09,1.22036e+07
19991104,681900,533600,148300,99247,4.53002e+09,4.77396e+09,1.32456e+07
19991105,684600,544500,140100,188350,4.56522e+09,4.8542e+09,1.39769e+07
19991108,683900,545800,138100,46951,4.5715e+09,4.88004e+09,1.39013e+07
19991109,684900,551000,133900,-169190,4.54381e+09,4.8229e+09,1.37177e+07
19991110,686500,535200,151300,-12728,4.54626e+09,4.84669e+09,1.30408e+07
19991111,693000,549700,143300,56761,4.55666e+09,4.88305e+09,1.32263e+07
19991112,693100,540000,153100,182985,4.58889e+09,4.95299e+09,1.29332e+07
19991115,692800,520500,172300,49702,4.59741e+09,4.95261e+09,1.21582e+07
19991116,694700,515800,178900,247531,4.64111e+09,5.0502e+09,1.22076e+07
19991117,695700,519100,176600,-42868,4.63407e+09,5.01648e+09,1.28254e+07
19991118,696100,520900,175200,99916,4.6537e+09,5.0687e+09,1.2767e+07
19991119,695500,534200,161300,-30886,4.64877e+09,5.04959e+09,1.28363e+07
19991122,697400,542400,155000,-52737,4.63761e+09,5.03785e+09,1.22696e+07
19991123,700800,513500,187300,-129558,4.62056e+09,4.97389e+09,1.02476e+07
19991124,704200,463200,241000,91101,4.63816e+09,5.0499e+09,8.13116e+06
19991126,708700,411100,297600,59208,4.64457e+09,5.13905e+09,4.87928e+06
19991129,708400,383600,324800,74909,4.65679e+09,5.1023e+09,3.22865e+06
19991130,712300,352900,359400,-159915,4.63452e+09,5.07212e+09,2.19516e+06
19991201,712400,340500,371900,47386,4.63975e+09,5.08304e+09,1.19193e+06
19991202,712700,333400,379300,63141,4.65254e+09,5.14484e+09,880938
19991203,712500,350100,362400,58582,4.66439e+09,5.20883e+09,1.08934e+06
19991206,710100,362200,347900,183064,4.6905e+09,5.18756e+09,2.15835e+06
19991207,709600,363600,346000,40560,4.69868e+09,5.11622e+09,2.48988e+06
19991208,712700,332600,380100,31793,4.70275e+09,5.14028e+09,1.96206e+06
19991209,713600,322700,390900,65516,4.71326e+09,5.14484e+09,939973
19991210,715400,295200,420200,18775,4.71957e+09,5.13029e+09,-462162
19991213,720300,267300,453000,32517,4.72427e+09,5.17437e+09,-1.36029e+06
19991214,719500,230600,488900,-81467,4.71114e+09,5.10201e+09,-3.51892e+06
19991215,719300,234100,485200,-23855,4.70236e+09,5.12726e+09,-3.49458e+06
19991216,718300,229400,488900,89713,4.71895e+09,5.15572e+09,-3.36811e+06
19991217,717800,239900,477900,-1602,4.72814e+09,5.16787e+09,-3.11712e+06
19991220,715600,256900,458700,14035,4.73172e+09,5.17779e+09,-2.15582e+06
19991221,715500,268200,447300,64797,4.74817e+09,5.22093e+09,-1.43982e+06
19991222,715300,285400,429900,-42854,4.74316e+09,5.22102e+09,-232790
19991223,715100,305100,410000,-29679,4.73864e+09,5.27533e+09,1.48888e+06
19991227,716100,334400,381700,-3358,4.7417e+09,5.31227e+09,3.22585e+06
19991228,715500,367700,347800,11865,4.75863e+09,5.29203e+09,4.95121e+06
19991229,714700,418900,295800,155453,4.78439e+09,5.3928e+09,7.84521e+06
19991230,713500,460700,252800,50707,4.79788e+09,5.38313e+09,1.00931e+07
19991231,712700,482500,230200,-71540,4.79767e+09,5.14937e+09,1.08207e+07
20000103,710100,492100,218000,-287241,4.74382e+09,5.05868e+09,1.15551e+07
20000104,711500,518200,193300,-317910,4.6839e+09,4.89766e+09,1.09324e+07
20000105,714900,510800,204100,79670,4.70216e+09,4.95072e+09,9.26468e+06
20000106,720100,504000,216100,-8042,4.69807e+09,4.93751e+09,7.74422e+06
20000107,719900,476800,243100,243146,4.74231e+09,5.10374e+09,6.22461e+06
20000110,719800,475300,244500,31185,4.7463e+09,5.09837e+09,6.16748e+06
20000111,718500,496800,221700,-41991,4.73914e+09,4.99914e+09,7.7604e+06
20000112,720200,497000,223200,-50007,4.73328e+09,4.98364e+09,8.8172e+06
20000113,719000,499900,219100,143105,4.7648e+09,5.06121e+09,9.7145e+06
20000114,723400,490800,232600,30075,4.76486e+09,5.16848e+09,1.09045e+07
20000118,719700,504800,214900,-1885,4.75501e+09,5.05435e+09,1.07719e+07
20000119,720400,496800,223600,-41357,4.75216e+09,4.99431e+09,1.01703e+07
20000120,723300,509800,213500,-23349,4.74925e+09,5.00223e+09,9.63505e+06
20000121,726200,470600,255600,70932,4.7666e+09,5.01126e+09,7.52084e+06
20000124,728400,429500,298900,-47045,4.76093e+09,4.90641e+09,5.10577e+06
20000125,732300,372700,359600,100397,4.76991e+09,4.93324e+09,2.68621e+06
20000126,732900,347500,385400,-16403,4.76319e+09,4.95402e+09,890912
20000127,733000,327400,405600,-132585,4.74374e+09,4.89717e+09,-215574
20000128,734200,306600,427600,17969,4.7444e+09,4.77301e+09,-1.75003e+06
20000131,730300,296600,433700,-24470,4.73125e+09,4.80736e+09,-2.41363e+06
20000201,732900,276100,456800,32406,4.74021e+09,4.86529e+09,-2.82744e+06
20000202,729900,257800,472100,-12482,4.73768e+09,4.88696e+09,-3.02668e+06
20000203,728500,272300,456200,71358,4.75363e+09,4.93492e+09,-2.11836e+06
20000204,730400,305300,425100,56819,4.75896e+09,4.93809e+09,-564778
20000207,727300,326100,401200,120351,4.77947e+09,4.91747e+09,151789
20000208,724100,347200,376900,102383,4.80399e+09,4.93481e+09,1.31506e+06
20000209,727300,329300,398000,87883,4.82635e+09,4.88136e+09,684201
20000210,728700,316200,412500,227302,4.8623e+09,4.90613e+09,202780
20000211,731100,286200,444900,95166,4.87846e+09,4.85038e+09,-613306
20000214,730600,286500,444100,10149,4.88123e+09,4.85196e+09,-982238
20000215,731500,265900,465600,-13480,4.88004e+09,4.92287e+09,-1.83172e+06
20000216,731400,259800,471600,191889,4.921e+09,4.9007e+09,-2.24234e+06
20000217,732600,263300,469300,103058,4.93462e+09,4.9381e+09,-2.35176e+06
20000218,736600,255000,481600,120965,4.94642e+09,4.85275e+09,-2.77393e+06
20000222,737100,249100,488000,-71783,4.93011e+09,4.86313e+09,-2.79868e+06
20000223,736700,250800,485900,195321,4.95955e+09,4.90617e+09,-2.43762e+06
20000224,741400,250400,491000,236691,5.00846e+09,4.92562e+09,-3.18881e+06
20000225,743100,234600,508500,94939,5.02095e+09,4.86809e+09,-4.10826e+06
20000228,743100,211000,532100,-127833,5.00188e+09,4.9249e+09,-5.24782e+06
20000229,744000,215800,528200,256034,5.0396e+09,5.0451e+09,-5.11911e+06
20000301,742100,232700,509400,121827,5.0817e+09,5.05507e+09,-4.17701e+06
20000302,745900,274200,471700,-28220,5.0658e+09,5.09804e+09,-3.02351e+06
20000303,743100,304800,438300,122813,5.08792e+09,5.17724e+09,-590552
20000306,742300,356100,386200,232685,5.13445e+09,5.14243e+09,738300
20000307,748300,353000,395300,242211,5.17288e+09,5.04384e+09,1.22538e+06
20000308,749200,357200,392000,-133203,5.14793e+09,5.01529e+09,1.21266e+06
20000309,750800,354100,396700,33996,5.15236e+09,5.15786e+09,810348
20000310,751200,351900,399300,50187,5.15633e+09,5.1758e+09,569733
20000313,751100,361200,389900,-85897,5.13378e+09,5.12315e+09,1.07223e+06
20000314,754400,353300,401100,-313389,5.07915e+09,4.98056e+09,832968
20000315,758600,385100,373500,-242416,5.03135e+09,5.05371e+09,2.02282e+06
20000316,755000,465300,289700,339204,5.06738e+09,5.31094e+09,7.40777e+06
20000317,756400,534100,222300,42943,5.08301e+09,5.29045e+09,1.04455e+07
20000320,758600,577200,181400,-55112,5.07763e+09,5.23535e+09,1.22798e+07
20000321,762000,608600,153400,268129,5.12633e+09,5.33045e+09,1.40593e+07
20000322,762800,630100,132700,-96462,5.11531e+09,5.40283e+09,1.52505e+07
20000323,764000,651400,112600,281885,5.15505e+09,5.43348e+09,1.65693e+07
20000324,764100,661100,103000,41534,5.16566e+09,5.4387e+09,1.68072e+07
20000327,764100,654000,110100,-126014,5.14431e+09,5.41356e+09,1.63836e+07
20000328,763400,647400,116000,-21121,5.14553e+09,5.36929e+09,1.5978e+07
20000329,762700,626300,136400,191677,5.17643e+09,5.336e+09,1.57502e+07
20000330,765400,644300,121100,258742,5.22279e+09,5.33655e+09,1.51005e+07
20000331,762500,649600,112900,142232,5.23809e+09,5.40676e+09,1.57803e+07
20000403,763100,669500,93600,323794,5.29599e+09,5.35717e+09,1.58449e+07
20000404,769500,685500,84000,-91858,5.28354e+09,5.38881e+09,1.51755e+07
20000405,768000,679200,88800,-143830,5.26227e+09,5.44502e+09,1.42511e+07
20000406,768800,647200,121600,-13693,5.25811e+09,5.53967e+09,1.42494e+07
20000407,768500,642100,126400,-104219,5.23601e+09,5.59069e+09,1.41125e+07
20000410,767800,639000,128800,105557,5.25485e+09,5.48316e+09,1.38211e+07
20000411,767800,625000,142800,285858,5.30674e+09,5.46704e+09,1.33478e+07
20000412,768200,615300,152900,297300,5.35788e+09,5.41028e+09,1.30256e+07
20000413,754800,576900,177900,-89211,5.35169e+09,5.17119e+09,1.23617e+07
20000414,757700,541800,215900,-303220,5.29245e+09,4.87276e+09,9.51528e+06
20000417,758500,516700,241800,-29541,5.29583e+09,4.97905e+09,7.71114e+06
20000418,758100,487500,270600,-233536,5.26074e+09,5.13223e+09,5.34109e+06
20000419,757400,429500,327900,96828,5.27547e+09,5.07726e+09,2.80861e+06
20000420,754700,386000,368700,114118,5.29307e+09,5.09569e+09,532689
20000424,759400,403400,356000,223706,5.33015e+09,5.1406e+09,1.89876e+06
20000425,754800,440700,314100,29976,5.34111e+09,5.26728e+09,4.54159e+06
20000426,753600,453700,299900,23683,5.3383e+09,5.19871e+09,6.11743e+06
20000427,749600,462000,287600,-59155,5.33309e+09,5.20913e+09,7.12949e+06
20000428,747600,471200,276400,-24697,5.32158e+09,5.20993e+09,7.46923e+06
20000501,745700,493100,252600,73411,5.32831e+09,5.24374e+09,9.4723e+06
20000502,745200,488800,256400,-81896,5.31628e+09,5.1485e+09,8.96272e+06
20000503,751100,487400,263700,-168856,5.28187e+09,5.08614e+09,8.72782e+06
20000504,747500,501400,246100,959735,5.43939e+09,5.09003e+09,8.74781e+06
20000505,746800,501800,245000,113893,5.46202e+09,5.15915e+09,8.96398e+06
20000508,746000,503100,242900,-3406,5.46123e+09,5.10805e+09,8.83977e+06
20000509,747400,527000,220400,19737,5.46712e+09,5.08468e+09,8.84347e+06
20000510,748100,520300,227800,19719,5.47205e+09,4.97862e+09,8.81658e+06
20000511,744300,552100,192200,183374,5.48731e+09,5.0451e+09,9.66767e+06
20000512,742600,554700,187900,-22383,5.47979e+09,5.04454e+09,1.02482e+07
20000515,740500,549700,190800,127326,5.50859e+09,5.11188e+09,1.02265e+07
20000516,744300,527300,217000,-59953,5.49146e+09,5.23048e+09,1.04898e+07
20000517,742100,533900,208200,-78416,5.47653e+09,5.17415e+09,1.22227e+07
20000518,740300,544700,195600,25020,5.47876e+09,5.14276e+09,1.32699e+07
20000519,740300,536700,203600,-125791,5.46231e+09,5.03064e+09,1.20802e+07
20000522,738800,529500,209300,32105,5.47081e+09,5.01584e+09,1.18615e+07
20000523,742000,502500,239500,122557,5.48723e+09,4.92949e+09,9.97382e+06
20000524,744400,478700,265700,100886,5.50855e+09,5.02612e+09,8.36287e+06
20000525,745800,437700,308100,-33087,5.50593e+09,4.95072e+09,5.50154e+06
20000526,746000,440900,305100,175397,5.53153e+09,4.92778e+09,5.61344e+06
20000530,746200,430600,315600,-104580,5.50969e+09,5.06645e+09,4.89953e+06
20000531,745500,451000,294500,104780,5.53276e+09,5.04722e+09,5.46605e+06
20000601,729500,428800,300700,3982,5.52501e+09,5.04345e+09,4.72106e+06
20000602,730700,473200,257500,-127740,5.48949e+09,5.15089e+09,7.09023e+06
20000605,728200,531200,197000,-157739,5.4668e+09,5.06152e+09,9.8892e+06
20000606,729700,540600,189100,-81292,5.45623e+09,5.00801e+09,1.02189e+07
20000607,727700,534000,193700,139265,5.47956e+09,5.03887e+09,9.96538e+06
20000608,727100,511000,216100,-99679,5.46048e+09,4.99659e+09,8.45371e+06
20000609,729000,487900,241100,56924,5.47018e+09,5.01208e+09,6.85733e+06
20000612,731600,466800,264800,-52004,5.46822e+09,4.97223e+09,6.19516e+06
20000613,730400,460800,269600,99918,5.48688e+09,5.00091e+09,5.88835e+06
20000614,729000,450700,278300,-22124,5.48295e+09,4.98528e+09,6.01767e+06
20000615,727900,468600,259300,82031,5.49897e+09,4.99908e+09,6.94119e+06
20000616,729200,461200,268000,69357,5.50681e+09,4.92975e+09,7.0274e+06
20000619,729600,456200,273400,159821,5.53342e+09,4.98101e+09,6.86154e+06
20000620,729300,435200,294100,35244,5.53185e+09,4.94528e+09,5.73382e+06
20000621,730100,425100,305000,135099,5.55073e+09,4.94437e+09,4.71028e+06
20000622,718600,414500,304100,-159046,5.52498e+09,4.85002e+09,3.47986e+06
20000623,719000,395400,323600,-27965,5.52901e+09,4.81442e+09,2.46933e+06
20000626,717400,376600,340800,86337,5.54594e+09,4.85611e+09,1.07724e+06
20000627,717400,360800,356600,-157377,5.521e+09,4.80749e+09,33233
20000628,716500,354700,361800,50722,5.53207e+09,4.83816e+09,-553351
20000629,716400,376400,340000,131108,5.55626e+09,4.81561e+09,-79039
20000630,716100,386800,329300,75508,5.57267e+09,4.78838e+09,304281
20000703,719000,405400,313600,-61086,5.5617e+09,4.88652e+09,1.37771e+06
20000705,720300,410200,310100,162892,5.59721e+09,4.84362e+09,1.63639e+06
20000706,711000,407000,304000,9575,5.599e+09,4.78498e+09,2.12028e+06
20000707,710400,414800,295600,67699,5.60825e+09,4.84001e+09,2.86084e+06
20000710,708400,458100,250300,74078,5.62555e+09,4.83186e+09,5.1562e+06
20000711,708300,482600,225700,-7406,5.62405e+09,4.86826e+09,6.92545e+06
20000712,707700,506300,201400,98951,5.64488e+09,4.90582e+09,8.27588e+06
20000713,704500,541000,163500,-165791,5.61456e+09,4.87394e+09,1.03392e+07
20000714,708100,567500,140600,10866,5.61041e+09,4.93881e+09,1.13127e+07
20000717,708200,579200,129000,60758,5.62361e+09,4.94826e+09,1.24408e+07
20000718,708800,582200,126600,-86395,5.6093e+09,4.90048e+09,1.27388e+07
20000719,708600,586700,121900,-118082,5.58521e+09,4.83999e+09,1.27052e+07
20000720,709600,573100,136500,201201,5.62104e+09,4.89863e+09,1.21615e+07
20000721,711600,528300,183300,-47663,5.61899e+09,4.81842e+09,9.77358e+06
20000724,716400,501400,215000,-36927,5.61365e+09,4.8202e+09,8.25198e+06
20000725,717600,484500,233100,94362,5.62786e+09,4.83195e+09,7.22113e+06
20000726,716800,478800,238000,20227,5.62808e+09,4.79055e+09,6.53858e+06
20000727,714100,427200,286900,59540,5.63756e+09,4.7343e+09,5.03103e+06
20000728,715400,418100,297300,-61712,5.6282e+09,4.67516e+09,3.77996e+06
20000731,716100,408500,307600,38319,5.63572e+09,4.69361e+09,2.99241e+06
20000801,715200,388200,327000,83358,5.64917e+09,4.73648e+09,2.3899e+06
20000802,711500,392400,319100,-23730,5.64448e+09,4.70128e+09,2.21703e+06
20000803,710300,399900,310400,17383,5.64657e+09,4.7259e+09,2.71188e+06
20000804,709900,431300,278600,64863,5.65792e+09,4.77874e+09,5.0893e+06
20000807,707900,463400,244500,15416,5.65888e+09,4.82485e+09,7.18386e+06
20000808,703400,502400,201000,85512,5.67128e+09,4.8107e+09,9.27712e+06
20000809,698600,512200,186400,-86368,5.6548e+09,4.75337e+09,1.03782e+07
20000810,697600,516200,181400,-1912,5.65737e+09,4.71936e+09,1.06851e+07
20000811,705500,511000,194500,184986,5.68861e+09,4.83152e+09,1.09773e+07
20000814,705000,526800,178200,41596,5.69679e+09,4.89256e+09,1.16254e+07
20000815,705700,532600,173100,-80219,5.67895e+09,4.86783e+09,1.23684e+07
20000816,705200,537900,167300,-49149,5.67351e+09,4.85689e+09,1.27812e+07
20000817,704900,568800,136100,138031,5.70112e+09,4.89995e+09,1.41874e+07
20000818,701100,566100,135000,-56688,5.69221e+09,4.87332e+09,1.43199e+07
20000821,702600,552700,149900,42236,5.69938e+09,4.88762e+09,1.34201e+07
20000822,702400,538400,164000,73233,5.7106e+09,4.91237e+09,1.2607e+07
20000823,702000,523200,178800,78156,5.7217e+09,4.92715e+09,1.19014e+07
20000824,701600,527100,174500,-10874,5.72493e+09,4.88777e+09,1.21252e+07
20000825,697800,500400,197400,-277,5.72704e+09,4.88946e+09,1.08589e+07
20000828,697500,485100,212400,-7634,5.72885e+09,4.83843e+09,9.66088e+06
20000829,698400,462900,235500,57358,5.74224e+09,4.83793e+09,8.2557e+06
20000830,699200,455900,243300,53939,5.75306e+09,4.85951e+09,7.82399e+06
20000831,698800,449600,249200,141095,5.77643e+09,4.90315e+09,7.48323e+06
20000901,698200,453700,244500,93877,5.79324e+09,4.91547e+09,7.66128e+06
20000905,697900,455500,242400,-53393,5.78377e+09,4.89537e+09,7.84954e+06
20000906,696300,479600,216700,-29853,5.77953e+09,4.86378e+09,8.63624e+06
20000907,692800,488200,204600,120616,5.80259e+09,4.8797e+09,9.41346e+06
20000908,690900,491900,199000,-15044,5.79511e+09,4.83882e+09,9.6745e+06
20000911,690600,517700,172900,45527,5.80095e+09,4.82422e+09,1.05477e+07
20000912,690300,510300,180000,2872,5.79978e+09,4.811e+09,9.81329e+06
20000913,690000,512600,177400,-22304,5.79802e+09,4.80786e+09,9.61033e+06
20000914,691800,476600,215200,-32509,5.79464e+09,4.8138e+09,8.20892e+06
20000915,692900,472000,220900,74315,5.80731e+09,4.78758e+09,7.5448e+06
20000918,693700,464000,229700,-73868,5.79221e+09,4.68582e+09,6.60015e+06
20000919,695600,425100,270500,-20121,5.78309e+09,4.73782e+09,4.72917e+06
20000920,696400,407200,289200,37853,5.7913e+09,4.73244e+09,3.31534e+06
20000921,695300,399300,296000,63271,5.80485e+09,4.68264e+09,2.39327e+06
20000922,696400,350500,345900,84393,5.81642e+09,4.75507e+09,218661
20000925,691600,324600,367000,-3111,5.81567e+09,4.71549e+09,-456937
20000926,692400,309600,382800,106833,5.83387e+09,4.7094e+09,-732489
20000927,692100,287800,404300,83620,5.84581e+09,4.73153e+09,-950304
20000928,691100,313100,378000,-21066,5.83854e+09,4.8332e+09,966132
20000929,689100,327400,361700,47892,5.85516e+09,4.7729e+09,1.70503e+06
20001002,685700,343400,342300,87972,5.86708e+09,4.73401e+09,3.13714e+06
20001003,685200,384800,300400,-13914,5.86572e+09,4.69831e+09,4.65959e+06
20001004,682800,377900,304900,-21939,5.85612e+09,4.66176e+09,4.85107e+06
20001005,682000,403600,278400,64682,5.86504e+09,4.65454e+09,5.74006e+06
20001006,683200,393900,289300,26965,5.87019e+09,4.58428e+09,4.80995e+06
20001009,683900,385100,298800,-29858,5.86919e+09,4.57769e+09,4.34588e+06
20001010,684500,385800,298700,59829,5.87905e+09,4.54686e+09,3.96935e+06
20001011,686400,358100,328300,-27714,5.87458e+09,4.52048e+09,3.56376e+06
20001012,688000,337100,350900,56557,5.89053e+09,4.40788e+09,2.18202e+06
20001013,689200,317800,371400,-220539,5.84754e+09,4.49772e+09,672638
20001016,688800,300500,388300,50801,5.85874e+09,4.54852e+09,-125692
20001017,689900,303000,386900,187754,5.89146e+09,4.47484e+09,-554074
20001018,690800,285100,405700,19058,5.89654e+09,4.44757e+09,-1.58811e+06
20001019,690200,269200,421000,-259862,5.85123e+09,4.55278e+09,-2.07204e+06
20001020,690700,283900,406800,-42388,5.84349e+09,4.56738e+09,-957349
20001023,689800,272300,417500,-14488,5.84158e+09,4.57579e+09,-1.26212e+06
20001024,691100,287300,403800,85728,5.85648e+09,4.60195e+09,-412947
20001025,689700,318600,371100,83060,5.87417e+09,4.51624e+09,762788
20001026,690300,351200,339100,28209,5.88268e+09,4.52059e+09,2.17148e+06
20001027,690400,369700,320700,91984,5.89406e+09,4.5411e+09,3.32442e+06
20001030,687800,411600,276200,278446,5.93802e+09,4.6104e+09,6.03696e+06
20001031,687900,441800,246100,109759,5.96727e+09,4.73002e+09,7.65468e+06
20001101,688100,467000,221100,-70837,5.95245e+09,4.70487e+09,9.54814e+06
20001102,686500,521600,164900,138641,5.97601e+09,4.73799e+09,1.17469e+07
20001103,689300,538400,150900,-77178,5.96156e+09,4.76839e+09,1.30324e+07
20001106,690500,535000,155500,101538,5.97735e+09,4.80639e+09,1.41728e+07
20001107,692600,549800,142800,-11468,5.97765e+09,4.81189e+09,1.40474e+07
20001108,695300,550300,145000,-23365,5.97016e+09,4.78004e+09,1.38515e+07
20001109,695600,564500,131100,-131759,5.95088e+09,4.74191e+09,1.3966e+07
20001110,698200,557900,140300,-194001,5.91951e+09,4.68692e+09,1.34617e+07
20001113,703600,544800,158800,-35918,5.91366e+09,4.65392e+09,1.15234e+07
20001114,708700,529400,179300,33038,5.92359e+09,4.76928e+09,1.10811e+07
20001115,707200,492800,214400,49057,5.93325e+09,4.79631e+09,9.95804e+06
20001116,708700,476000,232700,104627,5.95112e+09,4.76512e+09,9.24807e+06
20001117,707400,481200,226200,60244,5.96263e+09,4.74805e+09,9.6103e+06
20001120,709500,470800,238700,51221,5.97398e+09,4.6672e+09,8.82394e+06
20001121,711000,459400,251600,90929,5.98576e+09,4.66684e+09,8.14964e+06
20001122,712500,416700,295800,48704,5.9931e+09,4.6124e+09,5.78746e+06
20001124,711500,408400,303100,-114446,5.97531e+09,4.6781e+09,4.8212e+06
20001127,710200,394700,315500,-12906,5.97064e+09,4.69164e+09,3.95356e+06
20001128,708800,407300,301500,121757,5.99357e+09,4.621e+09,4.65252e+06
20001129,707100,387700,319400,53937,5.99519e+09,4.64535e+09,4.5173e+06
20001130,707100,395200,311900,87234,6.01188e+09,4.59146e+09,5.81368e+06
20001201,705400,396900,308500,6612,6.00944e+09,4.61646e+09,6.27316e+06
20001204,703000,388200,314800,102372,6.0204e+09,4.64974e+09,5.97742e+06
20001205,700600,400900,299700,-84757,5.99651e+09,4.75966e+09,6.77806e+06
20001206,697800,434400,263400,27823,6.00546e+09,4.69517e+09,7.54124e+06
20001207,695000,440500,254500,60278,6.02403e+09,4.68197e+09,8.70832e+06
20001208,693100,455600,237500,130486,6.03682e+09,4.78211e+09,9.985e+06
20001211,690800,468500,222300,23234,6.03936e+09,4.78267e+09,1.09019e+07
20001212,689300,473300,216000,-154920,6.01308e+09,4.73304e+09,1.06368e+07
20001213,688400,477900,210500,-107138,5.99636e+09,4.67261e+09,1.096e+07
20001214,690800,479600,211200,-201830,5.95944e+09,4.607e+09,1.05122e+07
20001215,692200,463900,228300,-34961,5.95446e+09,4.5595e+09,9.73962e+06
20001218,695600,442200,253400,217699,5.9947e+09,4.66161e+09,8.43704e+06
20001219,698600,438700,259900,89462,6.01143e+09,4.62905e+09,6.78085e+06
20001220,706000,419700,286300,115736,6.04095e+09,4.57952e+09,5.02294e+06
20001221,706000,404100,301900,80704,6.05688e+09,4.61576e+09,4.19965e+06
20001222,706800,409700,297100,-81455,6.03435e+09,4.73408e+09,4.92238e+06
20001226,709100,419100,290000,182059,6.07141e+09,4.74357e+09,4.99517e+06
20001227,710100,462400,247700,65711,6.08438e+09,4.82887e+09,6.62461e+06
20001228,704800,499100,205700,123309,6.10704e+09,4.86621e+09,9.65276e+06
20001229,704900,521600,183300,-62598,6.09998e+09,4.82573e+09,1.11049e+07
20010102,704100,531300,172800,-121285,6.08208e+09,4.65613e+09,1.1536e+07
20010103,704500,554300,150200,-50163,6.06428e+09,4.79953e+09,1.25549e+07
20010104,702800,568200,134600,-111969,6.04341e+09,4.68224e+09,1.29192e+07
20010105,714400,542600,171800,-55200,6.0347e+09,4.60894e+09,9.46406e+06
20010108,716200,518700,197500,-320,6.0344e+09,4.65927e+09,6.37205e+06
20010109,716300,511400,204900,-38631,6.03071e+09,4.65135e+09,5.44768e+06
20010110,715700,507000,208700,35488,6.03578e+09,4.69854e+09,5.13325e+06
20010111,715100,512700,202400,146032,6.06477e+09,4.71442e+09,5.06873e+06
20010112,712000,510700,201300,-47016,6.04931e+09,4.66361e+09,5.14069e+06
20010116,711800,509400,202400,30102,6.05767e+09,4.69159e+09,5.14532e+06
20010117,712800,503100,209700,183958,6.09196e+09,4.69258e+09,4.72903e+06
20010118,710300,483500,226800,98817,6.10924e+09,4.68347e+09,3.97875e+06
20010119,710100,466200,243900,-32873,6.1058e+09,4.61922e+09,2.59478e+06
20010122,709400,462400,247000,-113166,6.08115e+09,4.66154e+09,2.07569e+06
20010123,707500,442300,265200,50121,6.0921e+09,4.74629e+09,1.41807e+06
20010124,705400,412800,292600,44939,6.10461e+09,4.74196e+09,1.05564e+06
20010125,704300,418300,286000,-191207,6.0673e+09,4.75863e+09,1.99748e+06
20010126,703700,444500,259200,-17116,6.06977e+09,4.75068e+09,4.38094e+06
20010129,705200,492400,212800,113075,6.08804e+09,4.79777e+09,8.02145e+06
20010130,705200,542500,162700,68712,6.09705e+09,4.81074e+09,1.01344e+07
20010131,700200,537600,162600,23614,6.09058e+09,4.77656e+09,1.15474e+07
20010201,697300,551400,145900,691,6.08831e+09,4.76358e+09,1.28094e+07
20010202,698300,561700,136600,-136701,6.06896e+09,4.74268e+09,1.35112e+07
20010205,697300,559800,137500,21101,6.0689e+09,4.76468e+09,1.37249e+07
20010206,695900,573300,122600,942,6.0712e+09,4.76378e+09,1.44389e+07
20010207,695300,544500,150800,109012,6.09421e+09,4.76119e+09,1.32024e+07
20010208,690700,526600,164100,-5025,6.09735e+09,4.68782e+09,1.2362e+07
20010209,687500,522600,164900,4097,6.10304e+09,4.6383e+09,1.21481e+07
20010212,685800,524300,161500,114300,6.11849e+09,4.68098e+09,1.23646e+07
20010213,686900,500400,186500,59408,6.12858e+09,4.68121e+09,1.13569e+07
20010214,685100,489900,195200,-172398,6.10221e+09,4.66458e+09,1.06716e+07
20010215,678000,477100,200900,-43587,6.08858e+09,4.68287e+09,1.03543e+07
20010216,677300,474300,203000,84994,6.10833e+09,4.63304e+09,1.01115e+07
20010220,676900,469600,207300,63538,6.12413e+09,4.57918e+09,9.67949e+06
20010221,678900,471700,207200,-14677,6.12625e+09,4.53012e+09,8.42479e+06
20010222,679900,440600,239300,1850,6.12359e+09,4.48435e+09,5.79768e+06
20010223,683200,408200,275000,-44812,6.11084e+09,4.46522e+09,4.05411e+06
20010226,683900,379700,304200,-60312,6.09699e+09,4.56082e+09,2.35833e+06
20010227,683800,360000,323800,76451,6.11001e+09,4.53284e+09,1.35506e+06
20010228,686900,339100,347800,102697,6.13073e+09,4.50509e+09,1.11503e+06
20010301,687400,346000,341400,22775,6.1349e+09,4.50509e+09,1.41855e+06
20010302,683500,362700,320800,98871,6.15494e+09,4.51252e+09,2.78785e+06
20010305,681700,365000,316700,16477,6.15814e+09,4.52426e+09,3.19404e+06
20010306,680800,381500,299300,-42968,6.15346e+09,4.53994e+09,4.23237e+06
20010307,674900,402100,272800,86597,6.17058e+09,4.52336e+09,5.80803e+06
20010308,670700,411600,259100,154641,6.20067e+09,4.50687e+09,7.05159e+06
20010309,670100,430400,239700,11246,6.20325e+09,4.42596e+09,8.20914e+06
20010312,672200,420000,252200,-28609,6.19733e+09,4.29053e+09,7.62429e+06
20010313,673200,409200,264000,-112699,6.17709e+09,4.30566e+09,6.36403e+06
20010314,676500,358500,318000,-53354,6.17243e+09,4.22318e+09,4.0078e+06
20010315,678500,316400,362100,-25132,6.16921e+09,4.24677e+09,573964
20010316,682500,239700,442800,179315,6.20002e+09,4.18496e+09,-4.63223e+06
20010319,683000,211800,471200,-108865,6.18762e+09,4.26173e+09,-6.8682e+06
20010320,683300,198800,484500,155172,6.21647e+09,4.20306e+09,-7.97926e+06
20010321,685400,189800,495600,189065,6.24952e+09,4.12813e+09,-8.68223e+06
20010322,681900,172800,509100,219226,6.28117e+09,4.03423e+09,-9.56504e+06
20010323,683400,161300,522100,-225819,6.24249e+09,4.11015e+09,-1.03997e+07
20010326,683600,171100,512500,-251474,6.199e+09,4.17974e+09,-1.08843e+07
20010327,683700,176100,507600,-170496,6.17089e+09,4.24614e+09,-1.09302e+07
20010328,683800,176600,507200,106325,6.19087e+09,4.19419e+09,-1.06153e+07
20010329,690700,208000,482700,56517,6.19805e+09,4.25966e+09,-8.24042e+06
20010330,689500,271500,418000,-34626,6.19131e+09,4.29653e+09,-4.10542e+06
20010402,692500,307400,385100,67822,6.20352e+09,4.27288e+09,-1.27981e+06
20010403,702300,297800,404500,192650,6.2365e+09,4.18696e+09,-1.54977e+06
20010404,695800,320500,375300,-21932,6.23393e+09,4.18093e+09,-73371
20010405,696700,336900,359800,-204921,6.19666e+09,4.33852e+09,1.19327e+06
20010406,695900,357100,338800,52669,6.20113e+09,4.25446e+09,2.6374e+06
20010409,699100,345400,353700,10840,6.19679e+09,4.31466e+09,2.67031e+06
20010410,698600,404100,294500,-18061,6.19977e+09,4.41162e+09,6.26831e+06
20010411,700700,481200,219500,-170192,6.17036e+09,4.4006e+09,9.00251e+06
20010412,702500,497100,205400,53955,6.1797e+09,4.4835e+09,1.03275e+07
20010416,711100,544700,166400,27682,6.18207e+09,4.55746e+09,1.22056e+07
20010417,712000,572400,139600,144066,6.21105e+09,4.64875e+09,1.36453e+07
20010418,712400,591000,121400,514782,6.30425e+09,4.80191e+09,1.47782e+07
20010419,708700,583100,125600,222540,6.34084e+09,4.81158e+09,1.58907e+07
20010420,711500,595300,116200,-212646,6.30026e+09,4.775e+09,1.60322e+07
20010423,711700,600500,111200,-193771,6.26695e+09,4.72584e+09,1.60602e+07
20010424,713200,594600,118600,-52440,6.25746e+09,4.71355e+09,1.5455e+07
20010425,713900,577900,136000,228427,6.29411e+09,4.79654e+09,1.48377e+07
20010426,714200,570100,144100,165855,6.31718e+09,4.83765e+09,1.46408e+07
20010427,713400,599700,113700,240354,6.35503e+09,4.89464e+09,1.54637e+07
20010430,713000,598300,114700,65269,6.36092e+09,4.8847e+09,1.551e+07
20010501,712100,605300,106800,130436,6.37896e+09,4.91467e+09,1.63015e+07
20010502,708000,600000,108000,-44375,6.37104e+09,4.86035e+09,1.62988e+07
20010503,709700,604500,105200,-222907,6.33124e+09,4.80348e+09,1.58948e+07
20010504,710000,593300,116700,213101,6.37343e+09,4.85489e+09,1.57678e+07
20010507,710000,587200,122800,-30277,6.36537e+09,4.83767e+09,1.51375e+07
20010508,710700,574100,136600,-9634,6.36638e+09,4.84523e+09,1.41721e+07
20010509,710900,571900,139000,-90139,6.35015e+09,4.83933e+09,1.38693e+07
20010510,710000,578800,131200,111260,6.36583e+09,4.85218e+09,1.3701e+07
20010511,709400,556100,153300,-34502,6.3584e+09,4.8334e+09,1.25564e+07
20010514,708200,537600,170600,31122,6.36484e+09,4.8389e+09,1.19675e+07
20010515,706200,517600,188600,56102,6.37233e+09,4.85071e+09,1.12883e+07
20010516,704900,532500,172400,240020,6.41222e+09,4.974e+09,1.2131e+07
20010517,702400,551700,150700,152688,6.43754e+09,4.99826e+09,1.41802e+07
20010518,699700,567600,132100,46526,6.44435e+09,4.981e+09,1.56616e+07
20010521,694100,584700,109400,277706,6.49705e+09,5.00283e+09,1.70809e+07
20010522,692300,605400,86900,-46992,6.49013e+09,4.97921e+09,1.82537e+07
20010523,692000,628600,63400,-264054,6.44363e+09,4.90107e+09,1.83446e+07
20010524,691300,619600,71700,63626,6.46194e+09,4.90711e+09,1.81124e+07
20010525,691600,608400,83200,-116745,6.44145e+09,4.87678e+09,1.75306e+07
20010529,692400,591700,100700,-83593,6.42794e+09,4.85345e+09,1.66099e+07
20010530,693500,540100,153400,-164117,6.3952e+09,4.81808e+09,1.43124e+07
20010531,695300,521000,174300,72727,6.41244e+09,4.82778e+09,1.33557e+07
20010601,694800,493400,201400,2719,6.41917e+09,4.81492e+09,1.11456e+07
20010604,692200,471200,221000,73087,6.43856e+09,4.81005e+09,9.98226e+06
20010605,691300,474400,216900,58465,6.44727e+09,4.85622e+09,9.81161e+06
20010606,690800,467100,223700,-111411,6.42373e+09,4.80777e+09,9.45007e+06
20010607,688700,478200,210500,12893,6.42578e+09,4.81135e+09,1.01625e+07
20010608,687300,478800,208500,-20736,6.42043e+09,4.76936e+09,1.00876e+07
20010611,686900,455300,231600,-57075,6.4067e+09,4.72111e+09,8.22881e+06
20010612,686600,416500,270100,34039,6.41809e+09,4.67557e+09,5.45478e+06
20010613,685900,401000,284900,28134,6.42463e+09,4.62195e+09,4.17919e+06
20010614,686700,374800,311900,114964,6.44612e+09,4.53557e+09,2.10729e+06
20010615,678800,334200,344600,101229,6.46568e+09,4.44549e+09,69966
20010618,679600,295300,384300,86660,6.48128e+09,4.44457e+09,-2.11708e+06
20010619,680800,292900,387900,50965,6.48842e+09,4.43932e+09,-2.28607e+06
20010620,681100,298800,382300,62150,6.50189e+09,4.48437e+09,-1.85538e+06
20010621,678900,327200,351700,66056,6.51791e+09,4.49514e+09,-114652
20010622,677700,333100,344600,-67613,6.5004e+09,4.43085e+09,428578
20010625,677300,339100,338200,2413,6.49442e+09,4.38056e+09,694693
20010626,675900,341900,334000,-13897,6.49097e+09,4.37277e+09,409312
20010627,676200,344800,331400,75750,6.50313e+09,4.37146e+09,487864
20010628,674100,338900,335200,51650,6.51136e+09,4.39207e+09,310189
20010629,673200,347900,325300,-43157,6.50514e+09,4.38983e+09,744407
20010702,669900,398500,271400,19388,6.50584e+09,4.36353e+09,3.00756e+06
20010703,674900,433300,241600,-9022,6.50198e+09,4.39099e+09,4.90678e+06
20010705,675600,446400,229200,-73321,6.48807e+09,4.36717e+09,5.71641e+06
20010706,679900,456600,223300,-106240,6.46844e+09,4.31434e+09,6.1911e+06
20010709,680900,453100,227800,101318,6.48516e+09,4.32893e+09,6.03927e+06
20010710,682400,442800,239600,-27521,6.48042e+09,4.29855e+09,5.2402e+06
20010711,690200,381800,308400,54871,6.49339e+09,4.33882e+09,2.33214e+06
20010712,690400,378500,311900,-23912,6.48951e+09,4.43165e+09,1.90216e+06
20010713,699600,404900,294700,-1146,6.48809e+09,4.53094e+09,3.04026e+06
20010716,699100,398100,301000,161236,6.51723e+09,4.48436e+09,3.16106e+06
20010717,699000,418800,280200,105432,6.53491e+09,4.5188e+09,4.6588e+06
20010718,702900,448100,254800,14293,6.53359e+09,4.54672e+09,6.4657e+06
20010719,704700,461600,243100,73630,6.5481e+09,4.57483e+09,6.92353e+06
20010720,705300,466700,238600,-51235,6.5403e+09,4.5627e+09,7.18553e+06
20010723,701900,459500,242400,-54366,6.52953e+09,4.48603e+09,7.24265e+06
20010724,703900,440200,263700,-74151,6.51827e+09,4.43791e+09,5.86421e+06
20010725,704900,416200,288700,31901,6.51962e+09,4.5145e+09,5.0611e+06
20010726,707100,418200,288900,-32574,6.5141e+09,4.57721e+09,4.76943e+06
20010727,711700,407200,304500,19544,6.51866e+09,4.60861e+09,3.91586e+06
20010730,712000,415400,296600,5498,6.52056e+09,4.61622e+09,3.96344e+06
20010731,710500,469300,241200,44565,6.52722e+09,4.64647e+09,6.62428e+06
20010801,709700,486100,223600,41607,6.5372e+09,4.63347e+09,7.96691e+06
20010802,710900,494200,216700,11702,6.53086e+09,4.65303e+09,8.73282e+06
20010803,710500,510900,199600,-43827,6.5211e+09,4.63422e+09,9.83411e+06
20010806,710500,512600,197900,-69907,6.50683e+09,4.58828e+09,9.74791e+06
20010807,710300,515300,195000,42555,6.51346e+09,4.59166e+09,9.6314e+06
20010808,711000,505600,205400,-147618,6.48629e+09,4.53942e+09,8.63645e+06
20010809,712500,494700,217800,-965,6.48863e+09,4.55759e+09,7.70722e+06
20010810,713300,458900,254400,63891,6.5025e+09,4.5854e+09,5.99258e+06
20010813,714100,442600,271500,23427,6.50704e+09,4.60832e+09,4.95773e+06
20010814,714900,419400,295500,1333,6.50528e+09,4.61227e+09,4.38924e+06
20010815,714600,431200,283400,42872,6.51887e+09,4.59953e+09,5.36174e+06
20010816,714200,432300,281900,49494,6.52661e+09,4.61019e+09,5.60758e+06
20010817,716800,436700,280100,6871,6.53034e+09,4.60118e+09,5.49235e+06
20010820,717900,437400,280500,35537,6.53802e+09,4.62643e+09,5.65816e+06
20010821,719100,431800,287300,69325,6.55151e+09,4.60391e+09,4.85925e+06
20010822,718100,423000,295100,-15492,6.54558e+09,4.62569e+09,4.6855e+06
20010823,719600,395800,323800,42668,6.55323e+09,4.62796e+09,4.12499e+06
20010824,718700,399900,318800,-115723,6.52837e+09,4.68181e+09,4.57883e+06
20010827,718300,412700,305600,-18001,6.52511e+09,4.67173e+09,5.54694e+06
20010828,718600,444400,274200,-5975,6.52269e+09,4.62249e+09,7.76715e+06
20010829,720700,432900,287800,34542,6.52678e+09,4.60729e+09,7.58045e+06
20010830,720100,432100,288000,24053,6.5351e+09,4.55923e+09,7.20849e+06
20010831,719100,403900,315200,-44650,6.52788e+09,4.56252e+09,5.25179e+06
20010904,718500,407400,311100,36795,6.53372e+09,4.57262e+09,4.09598e+06
20010905,720900,383600,337300,58218,6.54722e+09,4.56607e+09,2.90472e+06
20010906,723900,361400,362500,119949,6.56155e+09,4.51334e+09,1.56775e+06
20010907,725400,341400,384000,18879,6.5654e+09,4.43746e+09,-781521
20010910,727700,305900,421800,17263,6.5697e+09,4.43922e+09,-3.14035e+06
20010917,737200,239000,498200,775238,6.6983e+09,4.24298e+09,-6.89854e+06
20010918,741000,165600,575400,158970,6.72974e+09,4.24036e+09,-9.57075e+06
20010919,749400,93900,655500,350528,6.79247e+09,4.20641e+09,-1.25566e+07
20010920,751500,85400,666100,479765,6.86861e+09,4.10069e+09,-1.25019e+07
20010921,753700,63100,690600,207216,6.90135e+09,4.04746e+09,-1.37527e+07
20010924,755100,48100,707000,-502897,6.81521e+09,4.17633e+09,-1.46075e+07
20010925,755200,62000,693200,-62984,6.80921e+09,4.21227e+09,-1.4881e+07
20010926,756900,58800,698100,213607,6.84917e+09,4.18087e+09,-1.50311e+07
20010927,756100,65600,690500,-195972,6.81413e+09,4.23578e+09,-1.47698e+07
20010928,755600,99300,656300,-374301,6.75064e+09,4.31849e+09,-1.27394e+07
20011001,755400,138100,617300,146161,6.77296e+09,4.28811e+09,-1.01813e+07
20011002,755200,209100,546100,-111479,6.7562e+09,4.34085e+09,-6.31068e+06
20011003,752400,249700,502700,-263452,6.71068e+09,4.42729e+09,-3.64055e+06
20011004,753000,323300,429700,-143743,6.68371e+09,4.4362e+09,525775
20011005,756100,405100,351000,-11968,6.67898e+09,4.43642e+09,4.68789e+06
20011008,769500,490400,279100,-95377,6.66333e+09,4.54588e+09,8.88436e+06
20011009,789200,568300,220900,-6090,6.66326e+09,4.60945e+09,1.119e+07
20011010,794100,625300,168800,373477,6.73085e+09,4.76099e+09,1.33475e+07
20011011,802500,678200,124300,337506,6.79193e+09,4.91099e+09,1.54546e+07
20011012,807100,704700,102400,-86072,6.78168e+09,4.88175e+09,1.66109e+07
20011015,807700,715300,92400,-28186,6.77692e+09,4.89072e+09,1.68623e+07
20011016,812700,720800,91900,175163,6.80943e+09,4.96115e+09,1.71123e+07
20011017,818200,724400,93800,-365863,6.74387e+09,4.90909e+09,1.67473e+07
20011018,819400,694500,124900,-97950,6.72561e+09,4.87569e+09,1.56987e+07
20011019,822100,664100,158000,111671,6.74404e+09,4.9283e+09,1.44272e+07
20011022,823600,678800,144800,230563,6.78362e+09,5.01149e+09,1.4103e+07
20011023,825400,665900,159500,-4611,6.78379e+09,5.02765e+09,1.31824e+07
20011024,828300,623100,205200,77793,6.7932e+09,5.05972e+09,1.15752e+07
20011025,829000,619500,209500,181964,6.82625e+09,5.13296e+09,1.13995e+07
20011026,828900,630300,198600,103394,6.84292e+09,5.16481e+09,1.18518e+07
20011029,829000,608200,220800,-315902,6.78571e+09,5.05372e+09,1.06773e+07
20011030,831400,575600,255800,-143711,6.76511e+09,5.00063e+09,8.72396e+06
20011031,832300,562900,269400,51328,6.77776e+09,5.00878e+09,7.94882e+06
20011101,831600,544000,287600,154585,6.80374e+09,5.08788e+09,7.10174e+06
20011102,830800,531100,299700,22563,6.8044e+09,5.11537e+09,6.38333e+06
20011105,829800,512000,317800,70240,6.81049e+09,5.18459e+09,5.98336e+06
20011106,825600,569100,256500,173580,6.83664e+09,5.21932e+09,9.7668e+06
20011107,819800,611600,208200,-6760,6.83704e+09,5.17935e+09,1.28536e+07
20011108,811200,643600,167600,-16131,6.83372e+09,5.08894e+09,1.36835e+07
20011109,808900,660200,148700,-35146,6.82881e+09,5.07355e+09,1.4584e+07
20011112,810200,657900,152300,-5040,6.82791e+09,5.08426e+09,1.41625e+07
20011113,808700,676600,132100,332086,6.88576e+09,5.15576e+09,1.49998e+07
20011114,806400,675200,131200,116508,6.9075e+09,5.15076e+09,1.48605e+07
20011115,803700,677900,125800,13454,6.90753e+09,5.10371e+09,1.46705e+07
20011116,805100,652300,152800,-91573,6.89297e+09,5.08591e+09,1.3752e+07
20011119,803100,671200,131900,189524,6.92562e+09,5.13048e+09,1.47366e+07
20011120,802200,674300,127900,-283747,6.87584e+09,5.09819e+09,1.44447e+07
20011121,804500,666900,137600,-32185,6.86776e+09,5.0815e+09,1.42014e+07
20011123,803800,658400,145400,186611,6.90012e+09,5.1368e+09,1.39e+07
20011126,803900,667500,136400,186336,6.94069e+09,5.16044e+09,1.46729e+07
20011127,804200,669700,134500,-41753,6.93165e+09,5.14083e+09,1.47684e+07
20011128,804200,654400,149800,-225317,6.89201e+09,5.08949e+09,1.36763e+07
20011129,802400,645300,157100,128994,6.91322e+09,5.11321e+09,1.35426e+07
20011130,802500,639500,163000,34587,6.91459e+09,5.11806e+09,1.35813e+07
20011203,800600,615500,185100,-141255,6.89054e+09,5.06772e+09,1.20528e+07
20011204,799800,596500,203300,199236,6.93016e+09,5.13942e+09,1.13862e+07
20011205,796200,617100,179100,374597,6.99506e+09,5.24488e+09,1.32085e+07
20011206,792300,652100,140200,3050,6.9946e+09,5.21156e+09,1.51422e+07
20011207,793100,681000,112100,-10743,6.9874e+09,5.19201e+09,1.60827e+07
20011210,790500,689000,101500,-247045,6.94255e+09,5.1084e+09,1.65394e+07
20011211,792900,675600,117300,73055,6.95477e+09,5.13619e+09,1.57686e+07
20011212,789700,634900,154800,-2498,6.95068e+09,5.08667e+09,1.40297e+07
20011213,788000,602500,185500,-155599,6.91766e+09,5.03797e+09,1.19936e+07
20011214,787600,561600,226000,32726,6.92778e+09,5.05745e+09,9.82718e+06
20011217,785400,546300,239100,127360,6.94832e+09,5.07919e+09,9.10814e+06
20011218,784400,534500,249900,88995,6.96119e+09,5.11848e+09,8.6812e+06
20011219,780400,530600,249800,-27596,6.96e+09,5.09929e+09,9.09131e+06
20011220,777600,549900,227700,-81092,6.94985e+09,5.04454e+09,1.07009e+07
20011221,765900,551200,214700,114797,6.96499e+09,5.01893e+09,1.18975e+07
20011224,762400,564100,198300,33988,6.97043e+09,5.0009e+09,1.24636e+07
20011226,760800,541800,219000,96265,6.98418e+09,5.02031e+09,1.16441e+07
20011227,758400,534600,223800,14429,6.98477e+09,5.03145e+09,1.14484e+07
20011228,755400,574900,180500,31629,6.99245e+09,5.02999e+09,1.29445e+07
20011231,754900,575000,179900,-76458,6.97767e+09,4.98562e+09,1.30977e+07
20020102,752400,580000,172400,-120889,6.95348e+09,4.94927e+09,1.31566e+07
20020103,751000,609900,141100,38223,6.95476e+09,4.97234e+09,1.50926e+07
20020104,745600,633900,111700,181106,6.99059e+09,4.95826e+09,1.63422e+07
20020107,741700,638100,103600,-38139,6.97871e+09,4.9113e+09,1.62238e+07
20020108,739800,631100,108700,-89228,6.95963e+09,4.89514e+09,1.58861e+07
20020109,740300,637100,103200,-28557,6.95392e+09,4.88609e+09,1.54022e+07
20020110,739600,621900,117700,-64656,6.94073e+09,4.88229e+09,1.38995e+07
20020111,739300,598400,140900,-133368,6.9178e+09,4.86123e+09,1.27779e+07
20020114,741300,542400,198900,-70008,6.90506e+09,4.85242e+09,9.96044e+06
20020115,743900,511600,232300,51924,6.91074e+09,4.89695e+09,7.67691e+06
20020116,747200,442400,304800,3116,6.9203e+09,4.84201e+09,3.78179e+06
20020117,745400,426900,318500,-11559,6.9177e+09,4.8713e+09,2.65615e+06
20020118,748800,399500,349300,37125,6.9283e+09,4.87331e+09,1.65552e+06
20020122,750600,378400,372200,28266,6.92968e+09,4.87802e+09,507704
20020123,751100,367900,383200,-64321,6.91673e+09,4.92313e+09,-358129
20020124,747200,363100,384100,-3242,6.91017e+09,4.92458e+09,32738
20020125,745500,383800,361700,-22003,6.90869e+09,4.9406e+09,1.71906e+06
20020128,744000,415800,328200,48881,6.91666e+09,4.94114e+09,3.84455e+06
20020129,742100,437300,304800,15113,6.92434e+09,4.84644e+09,5.55053e+06
20020130,741100,449000,292100,72299,6.93554e+09,4.88979e+09,6.47079e+06
20020131,724700,418900,305800,134316,6.95016e+09,4.94437e+09,6.718e+06
20020201,720400,431500,288900,-81546,6.94071e+09,4.86047e+09,7.04661e+06
20020204,720200,425600,294600,12935,6.94563e+09,4.78181e+09,6.82076e+06
20020205,719800,425800,294000,64976,6.95832e+09,4.75967e+09,7.44435e+06
20020206,720100,405100,315000,34949,6.97112e+09,4.72652e+09,6.48757e+06
20020207,721800,380100,341700,-37139,6.96366e+09,4.71478e+09,4.93529e+06
20020208,722100,362900,359200,-32268,6.95751e+09,4.77436e+09,3.9785e+06
20020211,721700,379600,342100,36286,6.96464e+09,4.84784e+09,4.72665e+06
20020212,720500,385000,335500,-18628,6.95982e+09,4.83611e+09,4.96858e+06
20020213,718800,450200,268600,105567,6.97952e+09,4.87753e+09,8.29622e+06
20020214,717400,481800,235600,42057,6.98814e+09,4.86655e+09,1.02433e+07
20020215,716500,499100,217400,28257,6.99225e+09,4.84309e+09,1.10914e+07
20020219,718100,486600,231500,-76331,6.9776e+09,4.77044e+09,1.06512e+07
20020220,719100,478800,240300,133878,7.00634e+09,4.82169e+09,1.05228e+07
20020221,719900,464600,255300,53200,7.01345e+09,4.79755e+09,1.00664e+07
20020222,720400,452300,268100,109356,7.03301e+09,4.83004e+09,9.54396e+06
20020225,720100,442300,277800,35053,7.03516e+09,4.887e+09,9.21629e+06
20020226,719600,446200,273400,53919,7.04331e+09,4.91517e+09,1.00016e+07
20020227,719100,465000,254100,45052,7.05262e+09,4.93377e+09,1.04928e+07
20020228,718100,473100,245000,8928,7.05659e+09,4.90627e+09,1.08215e+07
20020301,719800,518500,201300,161373,7.08885e+09,5.01105e+09,1.29923e+07
20020304,718100,575500,142600,343558,7.1426e+09,5.11672e+09,1.5878e+07
20020305,717800,630500,87300,-97552,7.13107e+09,5.07217e+09,1.7172e+07
20020306,719300,635800,83500,240987,7.1754e+09,5.17354e+09,1.78406e+07
20020307,721000,654900,66100,-67573,7.16434e+09,5.16541e+09,1.88409e+07
20020308,721300,660300,61000,39566,7.17508e+09,5.16415e+09,1.90656e+07
20020311,724600,661200,63400,82984,7.19041e+09,5.21544e+09,1.8949e+07
20020312,723900,655100,68800,-85624,7.1722e+09,5.20545e+09,1.84962e+07
20020313,722900,649200,73700,-148059,7.14462e+09,5.17301e+09,1.80802e+07
20020314,723000,655400,67600,7195,7.14413e+09,5.18284e+09,1.83574e+07
20020315,723000,654500,68500,153469,7.17177e+09,5.22842e+09,1.83434e+07
20020318,723500,669600,53900,84285,7.19162e+09,5.23818e+09,1.86662e+07
20020319,724200,662900,61300,100177,7.21094e+09,5.26841e+09,1.90086e+07
20020320,723700,655800,67900,-189386,7.17395e+09,5.20951e+09,1.83075e+07
20020321,726100,625700,100400,16400,7.17968e+09,5.22007e+09,1.68658e+07
20020322,726200,596300,129900,-103195,7.16173e+09,5.20103e+09,1.58988e+07
20020325,727000,550600,176400,-121244,7.13783e+09,5.1412e+09,1.30738e+07
20020326,725900,531900,194000,27390,7.14393e+09,5.17712e+09,1.12712e+07
20020327,725900,518500,207400,131257,7.16847e+09,5.22932e+09,1.03783e+07
20020328,727000,488400,238600,-3237,7.17133e+09,5.25268e+09,9.31747e+06
20020401,726400,471800,254600,31103,7.17679e+09,5.23824e+09,8.3784e+06
20020402,727000,471600,255400,30550,7.17922e+09,5.19903e+09,8.44999e+06
20020403,727400,450900,276500,-73957,7.16914e+09,5.14e+09,7.62059e+06
20020404,727700,454300,273400,33262,7.1757e+09,5.15107e+09,7.0963e+06
20020405,727300,446900,280400,-25744,7.16799e+09,5.16097e+09,6.47153e+06
20020408,724500,427300,297200,58257,7.17852e+09,5.18663e+09,5.18443e+06
20020409,723600,401200,322400,21047,7.18279e+09,5.17763e+09,4.21645e+06
20020410,720200,420100,300100,111588,7.20573e+09,5.21914e+09,6.22786e+06
20020411,719200,417500,301700,44521,7.21485e+09,5.13644e+09,6.49288e+06
20020412,717100,416600,300500,-13487,7.21016e+09,5.15485e+09,6.75581e+06
20020415,715000,418000,297000,-106733,7.18707e+09,5.10148e+09,6.83671e+06
20020416,714200,440300,273900,-1508,7.18182e+09,5.17482e+09,7.88044e+06
20020417,710700,443300,267400,-78371,7.16012e+09,5.1447e+09,8.39874e+06
20020418,707800,499900,207900,-4685,7.15682e+09,5.11267e+09,1.04152e+07
20020419,705600,537400,168200,47857,7.16966e+09,5.10743e+09,1.2716e+07
20020422,704400,534700,169700,-113234,7.14891e+09,5.04838e+09,1.26769e+07
20020423,709900,487800,222100,-13825,7.15279e+09,5.04746e+09,1.00862e+07
20020424,711100,455500,255600,-9579,7.15478e+09,5.02064e+09,7.92342e+06
20020425,717800,414600,303200,73848,7.1668e+09,5.0832e+09,5.73556e+06
20020426,718700,397200,321500,78415,7.18128e+09,5.04107e+09,4.46493e+06
20020429,721200,377900,343300,25669,7.1834e+09,5.01595e+09,2.84279e+06
20020430,721800,370800,351000,1398,7.1845e+09,5.08083e+09,2.16e+06
20020501,722400,374100,348300,74751,7.19839e+09,5.11423e+09,2.38329e+06
20020502,721700,381500,340200,44422,7.19601e+09,5.12249e+09,2.66212e+06
20020503,719900,387800,332100,66984,7.20581e+09,5.08608e+09,3.06313e+06
20020506,721600,395300,326300,80479,7.21992e+09,5.02318e+09,3.79612e+06
20020507,724200,371600,352600,-20469,7.21334e+09,5.04124e+09,2.80423e+06
20020508,724400,366200,358200,-254160,7.16474e+09,5.15932e+09,2.93139e+06
20020509,725700,346200,379500,76327,7.18856e+09,5.09728e+09,2.43764e+06
20020510,727900,313600,414300,87286,7.20557e+09,5.06882e+09,1.958e+06
20020513,727600,329900,397700,-41005,7.20174e+09,5.08025e+09,2.50026e+06
20020514,727200,375500,351700,16543,7.20328e+09,5.14702e+09,5.54411e+06
20020515,726000,385900,340100,-8557,7.20307e+09,5.12914e+09,6.33166e+06
20020516,728800,409600,319200,26178,7.21127e+09,5.13532e+09,7.86589e+06
20020517,729800,463800,266000,34932,7.21662e+09,5.16666e+09,1.08763e+07
20020520,739200,503000,236200,-120406,7.19312e+09,5.21224e+09,1.04783e+07
20020521,742600,509000,233600,-134188,7.17025e+09,5.145e+09,1.01903e+07
20020522,741900,504300,237600,-386,7.17263e+09,5.1531e+09,9.82774e+06
20020523,742000,497900,244100,107110,7.19026e+09,5.20984e+09,9.45039e+06
20020524,744900,474600,270300,-106834,7.1727e+09,5.18139e+09,8.40707e+06
20020528,747100,462700,284400,-29431,7.16789e+09,5.16267e+09,7.44317e+06
20020529,751100,459000,292100,-39887,7.16205e+09,5.16763e+09,6.47822e+06
20020530,759000,419100,339900,-23147,7.15704e+09,5.23181e+09,4.93637e+06
20020531,763200,398900,364300,-9184,7.15245e+09,5.27746e+09,3.67228e+06
20020603,767700,356700,411000,103772,7.16779e+09,5.17844e+09,1.25276e+06
20020604,771900,300200,471700,-8132,7.17111e+09,5.19058e+09,-1.79168e+06
20020605,772000,288200,483800,-14026,7.16561e+09,5.23116e+09,-2.86533e+06
20020606,773500,272900,500600,146982,7.19316e+09,5.16448e+09,-4.09229e+06
20020607,775900,240600,535300,-6887,7.19046e+09,5.20308e+09,-6.08254e+06
20020610,773700,252900,520800,16814,7.19223e+09,5.22207e+09,-5.89635e+06
20020611,775200,239000,536200,210984,7.23299e+09,5.17454e+09,-5.92356e+06
20020612,775900,241400,534500,38533,7.24131e+09,5.18757e+09,-5.51922e+06
20020613,775900,235100,540800,31869,7.2478e+09,5.1329e+09,-5.80572e+06
20020614,776800,233300,543500,-19291,7.24497e+09,5.13146e+09,-5.57022e+06
20020617,777300,239700,537600,-217290,7.20699e+09,5.26231e+09,-5.38079e+06
20020618,776900,264700,512200,-44093,7.20545e+09,5.2512e+09,-4.18998e+06
20020619,776900,271500,505400,184537,7.2403e+09,5.1973e+09,-2.94419e+06
20020620,784800,301800,483000,137424,7.26452e+09,5.22653e+09,-543558
20020621,784700,328100,456600,7992,7.26626e+09,5.16078e+09,1.0769e+06
20020624,787900,299100,488800,-31205,7.26041e+09,5.16518e+09,-121659
20020625,789600,278900,510700,36748,7.26344e+09,5.09244e+09,-1.04451e+06
20020626,791100,290700,500400,50841,7.27466e+09,5.09044e+09,-1.90682e+06
20020627,793500,283400,510100,-66930,7.25644e+09,5.15558e+09,-2.9636e+06
20020628,796900,268700,528200,44609,7.26259e+09,5.1846e+09,-3.28403e+06
20020701,796900,268600,528300,219486,7.30711e+09,5.06425e+09,-3.71571e+06
20020702,803400,263000,540400,195213,7.33661e+09,5.02706e+09,-4.00312e+06
20020703,803300,253100,550200,-57612,7.3238e+09,5.01143e+09,-5.11258e+06
20020705,803900,225400,578500,-333478,7.26574e+09,5.17199e+09,-6.09382e+06
20020708,806800,190600,616200,129312,7.29139e+09,5.1355e+09,-7.62269e+06
20020709,809700,170100,639600,277010,7.34155e+09,5.04803e+09,-9.06186e+06
20020710,816600,166400,650200,323520,7.39598e+09,4.92607e+09,-9.44412e+06
20020711,819500,207900,611600,-52503,7.39153e+09,4.94182e+09,-9.81577e+06
20020712,823300,167400,655900,80626,7.40287e+09,4.93167e+09,-1.28892e+07
20020715,845500,156800,688700,90091,7.41564e+09,5.13079e+09,-1.49716e+07
20020716,854900,151000,703900,240721,7.45377e+09,5.12934e+09,-1.53115e+07
20020717,856900,162300,694600,-56802,7.44617e+09,5.15456e+09,-1.49291e+07
20020718,865900,205500,660400,363468,7.51321e+09,5.05098e+09,-1.33032e+07
20020719,867900,204700,663200,472512,7.59048e+09,4.90351e+09,-1.29749e+07
20020722,891600,187200,704400,476148,7.66064e+09,4.77536e+09,-1.33887e+07
20020723,893400,176700,716700,364759,7.72842e+09,4.69228e+09,-1.35015e+07
20020724,907700,92800,814900,-772233,7.5884e+09,5.04203e+09,-1.4945e+07
20020725,913500,66400,847100,12418,7.59132e+09,5.07669e+09,-1.55611e+07
20020726,917600,55100,862500,-146716,7.57011e+09,5.13074e+09,-1.58405e+07
20020729,923500,96800,826700,-731856,7.44368e+09,5.42197e+09,-1.40223e+07
20020730,924600,214700,709900,49734,7.45227e+09,5.42923e+09,-7.37858e+06
20020731,916000,331700,584300,72544,7.46655e+09,5.44639e+09,-1.55207e+06
20020801,922200,413400,508800,-25010,7.47211e+09,5.37059e+09,2.83611e+06
20020802,926600,457900,468700,-57468,7.46098e+09,5.25733e+09,5.21412e+06
20020805,933300,459100,474200,-4004,7.45535e+09,5.13688e+09,4.92701e+06
20020806,938500,412300,526200,-1631,7.45462e+09,5.30855e+09,2.56951e+06
20020807,944200,389700,554500,67204,7.46721e+09,5.41188e+09,1.4293e+06
20020808,944400,394300,550100,63824,7.47708e+09,5.56811e+09,1.69704e+06
20020809,944900,447900,497000,12574,7.4787e+09,5.587e+09,5.1546e+06
20020812,951300,532000,419300,48543,7.48774e+09,5.61623e+09,9.46441e+06
20020813,956300,553900,402400,-218157,7.4466e+09,5.53267e+09,1.01822e+07
20020814,954500,615400,339100,279288,7.49602e+09,5.71736e+09,1.2012e+07
20020815,959100,659700,299400,143133,7.52083e+09,5.82157e+09,1.37146e+07
20020816,970300,700800,269500,-15268,7.517e+09,5.88721e+09,1.46178e+07
20020819,970400,751200,219200,252129,7.56139e+09,6.00495e+09,1.6112e+07
20020820,971800,802800,169000,-243550,7.52447e+09,5.92286e+09,1.77894e+07
20020821,1.0053e+06,848700,156600,242571,7.56073e+09,6.17032e+09,1.85305e+07
20020822,1.0231e+06,878200,144900,289073,7.61435e+09,6.45605e+09,1.89594e+07
20020823,1.0535e+06,943000,110500,-422099,7.54389e+09,6.61179e+09,1.90163e+07
20020826,1.0565e+06,996700,59800,206043,7.57869e+09,6.70439e+09,1.91589e+07
20020827,1.0618e+06,1.013e+06,48800,-305906,7.52828e+09,6.65742e+09,1.93171e+07
20020828,1.065e+06,986600,78400,-340841,7.46714e+09,6.56113e+09,1.78117e+07
20020829,1.0672e+06,962800,104400,25573,7.47194e+09,6.56983e+09,1.70348e+07
20020830,1.0691e+06,919800,149300,20025,7.47715e+09,6.59093e+09,1.53931e+07
20020903,1.0778e+06,815500,262300,-340778,7.4169e+09,6.41731e+09,1.04722e+07
20020904,1.0936e+06,661800,431800,35271,7.42408e+09,6.67214e+09,4.44769e+06
20020905,1.0967e+06,582400,514300,159086,7.45475e+09,6.61604e+09,-205790
20020906,1.0967e+06,550100,546600,-91057,7.43868e+09,6.72409e+09,-2.07487e+06
20020909,1.0941e+06,490200,603900,-27977,7.43865e+09,6.78189e+09,-3.79575e+06
20020910,1.0928e+06,537200,555600,-57883,7.42928e+09,6.81178e+09,-2.45419e+06
20020911,1.0877e+06,607300,480400,-6236,7.43089e+09,6.78863e+09,-1.36366e+06
20020912,1.0821e+06,629700,452400,99431,7.44879e+09,6.59414e+09,594805
20020913,1.0818e+06,638300,443500,61352,7.4597e+09,6.61748e+09,995572
20020916,1.0812e+06,650600,430600,41420,7.46384e+09,6.62319e+09,1.15421e+06
20020917,1.0897e+06,547500,542200,25356,7.46863e+09,6.53156e+09,-718744
20020918,1.0971e+06,453300,643800,70907,7.47571e+09,6.57777e+09,-2.4328e+06
20020919,1.098e+06,430300,667700,153494,7.50273e+09,6.42993e+09,-3.89085e+06
20020920,1.0995e+06,374100,725400,18446,7.51008e+09,6.46699e+09,-5.59464e+06
20020923,1.1035e+06,241200,862300,210812,7.54588e+09,6.3951e+09,-8.55189e+06
20020924,1.1094e+06,185100,924300,266639,7.59222e+09,6.2993e+09,-1.02921e+07
20020925,1.1094e+06,174200,935200,-361270,7.53139e+09,6.44118e+09,-1.15962e+07
20020926,1.1088e+06,183400,925400,-222238,7.48846e+09,6.57613e+09,-1.12049e+07
20020927,1.1096e+06,184800,924800,376571,7.55193e+09,6.4287e+09,-1.05799e+07
20020930,1.1085e+06,222100,886400,132516,7.57064e+09,6.34976e+09,-9.47532e+06
20021001,1.1026e+06,274500,828100,-244068,7.52876e+09,6.50839e+09,-6.64107e+06
20021002,1.103e+06,310800,792200,273996,7.58199e+09,6.36056e+09,-4.66325e+06
20021003,1.1055e+06,280800,824700,230799,7.62445e+09,6.29863e+09,-4.8044e+06
20021004,1.1085e+06,263900,844600,231066,7.67051e+09,6.15457e+09,-5.65375e+06
20021007,1.1107e+06,248400,862300,320371,7.72595e+09,6.03891e+09,-5.94477e+06
20021008,1.1122e+06,224500,887700,-103421,7.71442e+09,6.13598e+09,-7.45016e+06
20021009,1.1183e+06,185100,933200,389339,7.77847e+09,5.96076e+09,-8.51162e+06
20021010,1.1211e+06,161800,959300,-414519,7.71035e+09,6.16361e+09,-9.73566e+06
20021011,1.1226e+06,170300,952300,-514134,7.62251e+09,6.37133e+09,-9.77896e+06
20021014,1.1193e+06,216400,902900,21798,7.62721e+09,6.37178e+09,-7.35566e+06
20021015,1.1145e+06,394200,720300,-167071,7.60078e+09,6.59403e+09,-1.52124e+06
20021016,1.1118e+06,606000,505800,-17473,7.59888e+09,6.42706e+09,5.9894e+06
20021017,1.1115e+06,744400,367100,342526,7.65636e+09,6.58372e+09,1.0897e+07
20021018,1.113e+06,802900,310100,18881,7.65678e+09,6.63263e+09,1.30436e+07
20021021,1.12e+06,864100,255900,368217,7.72013e+09,6.82798e+09,1.44305e+07
20021022,1.1256e+06,880600,245000,-284240,7.67296e+09,6.76371e+09,1.45036e+07
20021023,1.135e+06,921700,213300,154934,7.70169e+09,6.88207e+09,1.5609e+07
20021024,1.1371e+06,937700,199400,-184786,7.66981e+09,6.80165e+09,1.58973e+07
20021025,1.1414e+06,950900,190500,336069,7.73282e+09,6.90749e+09,1.67357e+07
20021028,1.1634e+06,997900,165500,-135510,7.71132e+09,7.06553e+09,1.60945e+07
20021029,1.1606e+06,1.0031e+06,157500,-170082,7.68301e+09,7.0273e+09,1.57198e+07
20021030,1.1637e+06,988100,175600,219693,7.72661e+09,7.09907e+09,1.54758e+07
20021031,1.1644e+06,1.0088e+06,155600,-40084,7.71945e+09,7.10108e+09,1.52466e+07
20021101,1.1874e+06,1.0479e+06,139500,408702,7.78862e+09,7.3633e+09,1.55458e+07
20021104,1.1867e+06,1.0532e+06,133500,205065,7.82406e+09,7.38083e+09,1.57332e+07
20021105,1.187e+06,1.06e+06,127000,-4262,7.81864e+09,7.40702e+09,1.59562e+07
20021106,1.1866e+06,1.0556e+06,131000,313664,7.87436e+09,7.49664e+09,1.5795e+07
20021107,1.1862e+06,1.0658e+06,120400,-426912,7.80484e+09,7.33001e+09,1.5656e+07
20021108,1.1874e+06,1.0476e+06,139800,-209907,7.77123e+09,7.25528e+09,1.43903e+07
20021111,1.1907e+06,1.0071e+06,183600,-343405,7.70883e+09,7.1339e+09,1.19106e+07
20021112,1.1919e+06,967800,224100,141381,7.73616e+09,7.19428e+09,9.66937e+06
20021113,1.1964e+06,882500,313900,23563,7.73717e+09,7.21711e+09,5.74776e+06
20021114,1.1952e+06,863600,331600,177405,7.77908e+09,7.37712e+09,5.44238e+06
20021115,1.2031e+06,843900,359200,34991,7.78825e+09,7.54559e+09,5.85774e+06
20021118,1.1948e+06,890400,304400,40749,7.80759e+09,7.44153e+09,8.81799e+06
20021119,1.1914e+06,921500,269900,-8930,7.81389e+09,7.37447e+09,9.99276e+06
20021120,1.1866e+06,931000,255600,264933,7.85922e+09,7.47671e+09,1.13794e+07
20021121,1.1822e+06,956000,226200,525307,7.95978e+09,7.6134e+09,1.348e+07
20021122,1.1767e+06,954500,222200,30156,7.97139e+09,7.58453e+09,1.36904e+07
20021125,1.1761e+06,983400,192700,104759,7.98503e+09,7.56789e+09,1.49222e+07
20021126,1.1624e+06,1.0205e+06,141900,-351280,7.91553e+09,7.29016e+09,1.52836e+07
20021127,1.1609e+06,1.0278e+06,133100,486788,8.01033e+09,7.47277e+09,1.59586e+07
20021129,1.1603e+06,1.0282e+06,132100,63145,8.01315e+09,7.46834e+09,1.61495e+07
20021202,1.1601e+06,1.0387e+06,121400,86665,8.03896e+09,7.4661e+09,1.59055e+07
20021203,1.1581e+06,1.0417e+06,116400,-387675,7.97378e+09,7.34845e+09,1.5839e+07
20021204,1.1538e+06,1.0174e+06,136400,-254058,7.92618e+09,7.33115e+09,1.60394e+07
20021205,1.1539e+06,1.0187e+06,135200,-163685,7.88923e+09,7.2724e+09,1.60028e+07
20021206,1.1474e+06,977200,170200,44044,7.89298e+09,7.27361e+09,1.53371e+07
20021209,1.1476e+06,881900,265700,-249256,7.84353e+09,7.15835e+09,1.20934e+07
20021210,1.109e+06,741700,367300,82356,7.86174e+09,6.92401e+09,8.90755e+06
20021211,1.0734e+06,615300,458100,15722,7.86381e+09,6.55905e+09,6.03622e+06
20021212,1.074e+06,577000,497000,53476,7.87655e+09,6.55958e+09,4.75248e+06
20021213,1.0731e+06,547600,525500,111798,7.89849e+09,6.45462e+09,2.79525e+06
20021216,1.0683e+06,551000,517300,3598,7.89794e+09,6.5647e+09,3.20724e+06
20021217,1.0673e+06,543800,523500,37916,7.9048e+09,6.5086e+09,2.97544e+06
20021218,1.0698e+06,537400,532400,88211,7.91839e+09,6.4522e+09,2.22735e+06
20021219,1.0665e+06,503400,563100,39565,7.9276e+09,6.4031e+09,515803
20021220,1.0672e+06,508300,558900,6474,7.92605e+09,6.47561e+09,1.79437e+06
20021223,1.0675e+06,495500,572000,-3113,7.9193e+09,6.48025e+09,1.29355e+06
20021224,1.0653e+06,533800,531500,13020,7.92044e+09,6.43952e+09,1.93646e+06
20021226,1.0598e+06,535200,524600,-23603,7.91402e+09,6.38749e+09,2.13423e+06
20021227,1.0272e+06,495500,531700,-26414,7.90805e+09,5.94577e+09,2.95941e+06
20021230,1.0183e+06,468500,549800,21798,7.9103e+09,5.87949e+09,2.47521e+06
20021231,1.0155e+06,489400,526100,-27823,7.90441e+09,5.87998e+09,2.54018e+06
20030102,1.0041e+06,545100,459000,49603,7.91361e+09,6.01472e+09,4.71493e+06
20030103,1.0016e+06,604700,396900,53035,7.92411e+09,5.98403e+09,6.18967e+06
20030106,993700,746100,247600,231156,7.9659e+09,6.03689e+09,1.18083e+07
20030107,979000,825200,153800,-122603,7.9394e+09,5.86713e+09,1.57722e+07
20030108,975400,852300,123100,-172635,7.90507e+09,5.78307e+09,1.66839e+07
20030109,978800,850000,128800,292115,7.96002e+09,5.88177e+09,1.65318e+07
20030110,979900,838100,141800,31589,7.96622e+09,5.91092e+09,1.71127e+07
20030113,980100,834200,145900,-54601,7.95888e+09,5.89017e+09,1.66965e+07
20030114,980200,821300,158900,95179,7.97581e+09,5.90612e+09,1.62123e+07
20030115,981300,824000,157300,-197233,7.94142e+09,5.85276e+09,1.57839e+07
20030116,981600,803500,178100,-24977,7.93805e+09,5.84961e+09,1.46974e+07
20030117,982600,775200,207400,-183007,7.9024e+09,5.78379e+09,1.29474e+07
20030121,986300,746500,239800,-166058,7.87044e+09,5.70882e+09,1.05364e+07
20030122,995400,645600,349800,1825,7.87194e+09,5.71287e+09,4.99044e+06
20030123,1.0009e+06,570500,430400,41624,7.87882e+09,5.82197e+09,1.91446e+06
20030124,1.0066e+06,486800,519800,51295,7.89424e+09,5.72521e+09,-2.69184e+06
20030127,1.0123e+06,385100,627200,147398,7.91988e+09,5.6659e+09,-7.25922e+06
20030128,1.0155e+06,313900,701600,-116041,7.89897e+09,5.74183e+09,-9.72528e+06
20030129,1.0168e+06,277900,738900,-22796,7.89443e+09,5.77224e+09,-1.07959e+07
20030130,1.019e+06,217500,801500,292760,7.94566e+09,5.68434e+09,-1.30357e+07
20030131,1.0186e+06,216900,801700,-203673,7.9108e+09,5.75961e+09,-1.3365e+07
20030203,1.0192e+06,237900,781300,-49687,7.90348e+09,5.77895e+09,-1.22677e+07
20030204,1.0159e+06,232600,783300,174108,7.93566e+09,5.72325e+09,-1.11811e+07
20030205,1.0155e+06,236600,778900,53900,7.94366e+09,5.69847e+09,-1.05018e+07
20030206,1.0171e+06,245400,771700,130775,7.9664e+09,5.66884e+09,-9.40799e+06
20030207,1.0182e+06,222400,795800,111850,7.98598e+09,5.63029e+09,-9.53759e+06
20030210,1.0142e+06,238700,775500,-34722,7.98241e+09,5.63656e+09,-9.01085e+06
20030211,1.0118e+06,219300,792500,99075,8.00325e+09,5.56672e+09,-9.17905e+06
20030212,1.0133e+06,210000,803300,171651,8.03358e+09,5.49918e+09,-9.22173e+06
20030213,1.0138e+06,197300,816500,19849,8.03561e+09,5.48001e+09,-9.79826e+06
20030214,1.0138e+06,208500,805300,-167036,8.00853e+09,5.56421e+09,-9.26954e+06
20030218,1.0137e+06,277700,736000,-69200,7.99611e+09,5.64168e+09,-6.96142e+06
20030219,1.0103e+06,313600,696700,61296,8.00974e+09,5.58379e+09,-4.79522e+06
20030220,1.0091e+06,413500,595600,36058,8.01909e+09,5.54436e+09,-514585
20030221,1.0149e+06,578300,436600,102339,8.03678e+09,5.68874e+09,5.1623e+06
20030224,1.0148e+06,606000,408800,-51634,8.0243e+09,5.60792e+09,6.72432e+06
20030225,1.0156e+06,611400,404200,50571,8.03482e+09,5.63783e+09,6.63757e+06
20030226,1.018e+06,614700,403300,-57634,8.02215e+09,5.60446e+09,6.12279e+06
20030227,1.018e+06,623800,394200,62715,8.02982e+09,5.65478e+09,6.49209e+06
20030228,1.019e+06,630500,388500,55967,8.04078e+09,5.67151e+09,6.13823e+06
20030303,1.0193e+06,676800,342500,-57774,8.03144e+09,5.64736e+09,7.54528e+06
20030304,1.0261e+06,683000,343100,-49238,8.02465e+09,5.59139e+09,7.40149e+06
20030305,1.0292e+06,714000,315200,143345,8.05026e+09,5.62393e+09,7.35342e+06
20030306,1.0344e+06,698000,336400,11017,8.04928e+09,5.6181e+09,6.47546e+06
20030307,1.036e+06,684000,352000,50915,8.05936e+09,5.66566e+09,5.93283e+06
20030310,1.0458e+06,602000,443800,-32354,8.04756e+09,5.61207e+09,3.97347e+06
20030311,1.0514e+06,555800,495600,17314,8.0493e+09,5.59081e+09,1.51501e+06
20030312,1.0653e+06,479700,585600,-22590,8.04569e+09,5.67572e+09,-1.54097e+06
20030313,1.067e+06,458300,608700,-105823,8.0297e+09,5.87359e+09,-2.05057e+06
20030314,1.0701e+06,425300,644800,34115,8.0399e+09,5.89123e+09,-3.20167e+06
20030317,1.0682e+06,484500,583700,-9125,8.04114e+09,6.06978e+09,-55453
20030318,1.0623e+06,608000,454300,-6830,8.04134e+09,6.05854e+09,5.94717e+06
20030319,1.0553e+06,835500,219800,73963,8.05326e+09,6.05919e+09,1.26299e+07
20030320,1.0438e+06,884700,159100,68378,8.06388e+09,5.97277e+09,1.51652e+07
20030321,1.0448e+06,948200,96600,422686,8.13591e+09,6.09717e+09,1.79439e+07
20030324,1.0434e+06,965200,78200,-633347,8.02431e+09,5.90568e+09,1.76318e+07
20030325,1.0504e+06,982900,67500,236469,8.06778e+09,6.04249e+09,1.82401e+07
20030326,1.0526e+06,984200,68400,-111021,8.04785e+09,6.01594e+09,1.8146e+07
20030327,1.0522e+06,987300,64900,14025,8.04588e+09,6.01129e+09,1.83962e+07
20030328,1.0526e+06,978800,73800,-91063,8.02921e+09,5.99584e+09,1.81273e+07
20030331,1.0612e+06,971200,90000,-140567,7.99594e+09,5.93625e+09,1.73587e+07
20030401,1.0644e+06,938700,125700,166438,8.02873e+09,6.01018e+09,1.65124e+07
20030402,1.0639e+06,931100,132800,350789,8.09157e+09,6.12768e+09,1.66625e+07
20030403,1.065e+06,924900,140100,-37838,8.09123e+09,6.09776e+09,1.65185e+07
20030404,1.065e+06,926400,138600,43025,8.10031e+09,6.09616e+09,1.66914e+07
20030407,1.065e+06,953700,111300,47476,8.10569e+09,6.10829e+09,1.76104e+07
20030408,1.0646e+06,933500,131100,-73268,8.0883e+09,6.0864e+09,1.70437e+07
20030409,1.0662e+06,889800,176400,-143519,8.05786e+09,6.0382e+09,1.5239e+07
20030410,1.0668e+06,869200,197600,78936,8.07117e+09,6.07898e+09,1.41444e+07
20030411,1.0707e+06,825300,245400,-71,8.07138e+09,6.09761e+09,1.21679e+07
20030414,1.0706e+06,800900,269700,215239,8.11155e+09,6.19864e+09,1.19293e+07
20030415,1.0717e+06,759900,311800,121051,8.13285e+09,6.2651e+09,1.1974e+07
20030416,1.0687e+06,790200,278500,-143987,8.10586e+09,6.19028e+09,1.3364e+07
20030417,1.0652e+06,855600,209600,277019,8.15723e+09,6.25588e+09,1.55816e+07
20030421,1.0531e+06,898600,154500,17310,8.15696e+09,6.14687e+09,1.59091e+07
20030422,1.0466e+06,907400,139200,358796,8.22218e+09,6.22995e+09,1.73754e+07
20030423,1.0414e+06,918000,123400,100202,8.2502e+09,6.21616e+09,1.75125e+07
20030424,1.0404e+06,927800,112600,-146570,8.2233e+09,6.17169e+09,1.79559e+07
20030425,1.0405e+06,944000,96500,-239396,8.18269e+09,6.099e+09,1.83408e+07
20030428,1.0391e+06,944300,94800,357615,8.24684e+09,6.18535e+09,1.87985e+07
20030429,1.0392e+06,941900,97300,58177,8.25407e+09,6.20655e+09,1.88167e+07
20030430,1.0433e+06,948100,95200,36956,8.26048e+09,6.23763e+09,1.8799e+07
20030501,1.0433e+06,958000,85300,-45694,8.2577e+09,6.21578e+09,1.90166e+07
20030502,1.0413e+06,954900,86400,365283,8.32794e+09,6.30487e+09,1.94722e+07
20030505,1.0402e+06,960100,80100,57506,8.34493e+09,6.2974e+09,1.96478e+07
20030506,1.0364e+06,962700,73700,200103,8.37818e+09,6.33181e+09,2.00944e+07
20030507,1.0357e+06,977000,58700,-86400,8.36524e+09,6.30322e+09,2.03624e+07
20030508,1.034e+06,973000,61000,-173722,8.33673e+09,6.23525e+09,2.00468e+07
20030509,1.0325e+06,975500,57000,260067,8.38135e+09,6.30047e+09,1.99314e+07
20030512,1.0313e+06,977000,54300,301197,8.43433e+09,6.37563e+09,2.02027e+07
20030513,1.029e+06,976500,52500,-8435,8.43149e+09,6.35259e+09,2.01746e+07
20030514,1.0274e+06,974300,53100,6356,8.43132e+09,6.32851e+09,2.0026e+07
20030515,1.0261e+06,983000,43100,199214,8.46974e+09,6.36392e+09,2.08207e+07
20030516,1.024e+06,970100,53900,-23258,8.46199e+09,6.34642e+09,2.06419e+07
20030519,1.0232e+06,952200,71000,-446127,8.37657e+09,6.21878e+09,1.94415e+07
20030520,1.0211e+06,919700,101400,12180,8.38312e+09,6.20198e+09,1.7972e+07
20030521,1.0185e+06,897400,121100,98284,8.40235e+09,6.2148e+09,1.68092e+07
20030522,1.0153e+06,866200,149100,206338,8.44557e+09,6.26349e+09,1.49149e+07
20030523,1.0148e+06,821700,193100,172768,8.47842e+09,6.2923e+09,1.3505e+07
20030527,1.0145e+06,826200,188300,282904,8.53439e+09,6.39726e+09,1.4368e+07
20030528,1.0088e+06,855500,153300,5945,8.53616e+09,6.35358e+09,1.56101e+07
20030529,1.0036e+06,882900,120700,-20478,8.53112e+09,6.29409e+09,1.69735e+07
20030530,994300,893100,101200,326875,8.58272e+09,6.3507e+09,1.86829e+07
20030602,988400,909800,78600,128139,8.60642e+09,6.34346e+09,1.97782e+07
20030603,987100,913300,73800,20292,8.60923e+09,6.33428e+09,2.00158e+07
20030604,983600,934000,49600,405431,8.68401e+09,6.39797e+09,2.14664e+07
20030605,979600,941800,37800,207688,8.72767e+09,6.41022e+09,2.19352e+07
20030606,978700,945400,33300,-99053,8.70931e+09,6.37337e+09,2.20531e+07
20030609,978700,943000,35700,-383007,8.63607e+09,6.28199e+09,2.15546e+07
20030610,977900,944700,33200,205555,8.67518e+09,6.33278e+09,2.17442e+07
20030611,976000,937800,38200,370795,8.74332e+09,6.42019e+09,2.18369e+07
20030612,970900,923100,47800,75644,8.75786e+09,6.37211e+09,2.16164e+07
20030613,971900,917300,54600,-251398,8.71398e+09,6.30451e+09,2.09991e+07
20030616,971600,915600,56000,417590,8.78656e+09,6.43177e+09,2.1405e+07
20030617,967700,902400,65300,268,8.78986e+09,6.40733e+09,2.13497e+07
20030618,967400,899500,67900,-106892,8.77044e+09,6.37173e+09,2.09923e+07
20030619,953400,869200,84200,-356138,8.71493e+09,6.0741e+09,2.01662e+07
20030620,945600,832900,112700,-403,8.71343e+09,5.99499e+09,1.96195e+07
20030623,939300,779500,159800,-259163,8.66447e+09,5.8981e+09,1.70481e+07
20030624,927100,697300,229800,37062,8.66865e+09,5.9039e+09,1.42126e+07
20030625,914800,609000,305800,-55183,8.65859e+09,5.84709e+09,1.04916e+07
20030626,900800,531200,369600,98451,8.67957e+09,5.77882e+09,7.54614e+06
20030627,897500,476600,420900,-12711,8.67589e+09,5.72094e+09,4.89964e+06
20030630,895600,456900,438700,4759,8.67511e+09,5.69594e+09,3.64685e+06
20030701,872500,424400,448100,-66291,8.66732e+09,5.43847e+09,3.11174e+06
20030702,870700,443100,427600,21818,8.66774e+09,5.48436e+09,3.57525e+06
20030703,867100,456900,410200,5966,8.66854e+09,5.4329e+09,4.1971e+06
20030707,862600,533300,329300,156541,8.69473e+09,5.48813e+09,7.98965e+06
20030708,845600,562400,283200,101452,8.71447e+09,5.38635e+09,9.82786e+06
20030709,839500,632400,207100,-36442,8.7064e+09,5.33413e+09,1.26876e+07
20030710,837700,630700,207000,-191750,8.67178e+09,5.25683e+09,1.21885e+07
20030711,831800,649200,182600,122747,8.69329e+09,5.25606e+09,1.31543e+07
20030714,830100,648600,181500,181556,8.72766e+09,5.27684e+09,1.26914e+07
20030715,828400,646100,182300,-19310,8.72603e+09,5.24849e+09,1.25352e+07
20030716,826900,644300,182600,-22929,8.7236e+09,5.21274e+09,1.23243e+07
20030717,826400,628100,198300,-222775,8.68274e+09,5.15282e+09,1.15896e+07
20030718,824900,601400,223500,86423,8.69502e+09,5.20533e+09,1.06519e+07
20030721,825600,569000,256600,-88157,8.67865e+09,5.14616e+09,9.08801e+06
20030722,825500,550900,274600,136220,8.70339e+09,5.19361e+09,8.46566e+06
20030723,829700,505800,323900,46436,8.71445e+09,5.21818e+09,7.03678e+06
20030724,829900,499500,330400,10515,8.72148e+09,5.20619e+09,6.6331e+06
20030725,824700,464500,360200,136814,8.74739e+09,5.25921e+09,5.76781e+06
20030728,818800,488200,330600,20609,8.75149e+09,5.22495e+09,6.9926e+06
20030729,818900,502000,316900,-19723,8.74825e+09,5.20861e+09,7.58491e+06
20030730,818100,503400,314700,854,8.74674e+09,5.1949e+09,7.78665e+06
20030731,819000,511600,307400,48358,8.76155e+09,5.21646e+09,8.42452e+06
20030801,818400,497000,321400,-24642,8.75811e+09,5.16661e+09,7.53539e+06
20030804,818500,499800,318700,6581,8.76045e+09,5.16644e+09,7.05891e+06
20030805,820600,482100,338500,-76498,8.75269e+09,5.10231e+09,6.00176e+06
20030806,820900,471900,349000,-1243,8.74968e+09,5.11658e+09,4.87436e+06
20030807,818500,422100,396400,-766,8.74439e+09,5.12693e+09,3.21698e+06
20030808,818400,405200,413200,20773,8.7493e+09,5.15207e+09,2.77223e+06
20030811,814900,403700,411200,-7206,8.74583e+09,5.14877e+09,2.58054e+06
20030812,812700,424000,388700,23290,8.74672e+09,5.19843e+09,3.98945e+06
20030813,810100,481700,328400,-11526,8.74427e+09,5.16003e+09,6.72559e+06
20030814,805600,520300,285300,57547,8.75569e+09,5.17285e+09,8.9082e+06
20030815,803500,562800,240700,18628,8.75928e+09,5.17186e+09,1.12009e+07
20030818,800300,595800,204500,120190,8.77922e+09,5.19319e+09,1.30716e+07
20030819,797600,626300,171300,43509,8.7843e+09,5.18979e+09,1.45293e+07
20030820,795200,670600,124600,46997,8.79304e+09,5.17199e+09,1.66943e+07
20030821,794500,705600,88900,135895,8.8181e+09,5.19055e+09,1.78486e+07
20030822,795500,708100,87400,-224199,8.78614e+09,5.12236e+09,1.76549e+07
20030825,795000,724600,70400,-53824,8.77518e+09,5.1091e+09,1.76757e+07
20030826,797500,715700,81800,26747,8.77791e+09,5.14984e+09,1.7228e+07
20030827,799400,712500,86900,98177,8.79462e+09,5.17912e+09,1.71031e+07
20030828,798400,710200,88200,155521,8.82054e+09,5.22065e+09,1.70162e+07
20030829,798000,714000,84000,93860,8.83566e+09,5.23575e+09,1.72079e+07
20030902,797200,726100,71100,246432,8.87965e+09,5.29052e+09,1.78871e+07
20030903,797200,737600,59600,53478,8.89015e+09,5.29771e+09,1.84112e+07
20030904,796200,754100,42100,4431,8.89143e+09,5.29519e+09,1.92141e+07
20030905,796500,765800,30700,-136646,8.86731e+09,5.25562e+09,1.96854e+07
20030908,796600,770600,26000,222686,8.90425e+09,5.30447e+09,2.05138e+07
20030909,797400,765100,32300,-167235,8.87451e+09,5.26798e+09,1.98921e+07
20030910,797900,729100,68800,-308703,8.82118e+09,5.19779e+09,1.7875e+07
20030911,798100,720400,77700,75429,8.83359e+09,5.21944e+09,1.71078e+07
20030912,798000,696800,101200,54181,8.84545e+09,5.23383e+09,1.55996e+07
20030915,798000,656600,141400,-57113,8.83411e+09,5.22139e+09,1.34927e+07
20030916,798000,636100,161900,175827,8.86633e+09,5.28303e+09,1.30763e+07
20030917,797000,620500,176500,-4301,8.86612e+09,5.26225e+09,1.28155e+07
20030918,795400,624400,171000,185722,8.89771e+09,5.31457e+09,1.36796e+07
20030919,791200,627900,163300,8833,8.89734e+09,5.28612e+09,1.42189e+07
20030922,791200,628100,163100,-141845,8.87085e+09,5.22692e+09,1.40857e+07
20030923,789400,623900,165500,132976,8.89183e+09,5.25187e+09,1.38343e+07
20030924,789700,607800,181900,-205042,8.85412e+09,5.17514e+09,1.27611e+07
20030925,788100,553900,234200,-72846,8.84373e+09,5.12265e+09,1.02212e+07
20030926,792400,470500,321900,-4056,8.84063e+09,5.1016e+09,5.20368e+06
20030929,791700,442500,349200,25800,8.8435e+09,5.14463e+09,3.42735e+06
20030930,792100,378100,414000,14258,8.84345e+09,5.11201e+09,271851
20031001,791800,381600,410200,-18527,8.83968e+09,5.21182e+09,281041
20031002,790600,394600,396000,5248,8.84065e+09,5.22748e+09,986688
20031003,787500,437700,349800,-42663,8.83119e+09,5.25553e+09,4.20153e+06
20031006,783200,507700,275500,63078,8.84227e+09,5.24686e+09,8.68398e+06
20031007,777100,583700,193400,95376,8.85712e+09,5.23491e+09,1.30868e+07
20031008,774400,627000,147400,-43351,8.84869e+09,5.19374e+09,1.49655e+07
20031009,770100,653200,116900,100503,8.86564e+09,5.18054e+09,1.64977e+07
20031010,767000,661500,105500,13021,8.86683e+09,5.14363e+09,1.69793e+07
20031013,766400,665500,100900,212714,8.90385e+09,5.18748e+09,1.74483e+07
20031014,765000,676600,88400,68828,8.91726e+09,5.20717e+09,1.7964e+07
20031015,764700,684300,80400,-111741,8.89536e+09,5.18127e+09,1.80879e+07
20031016,763300,688100,75200,66397,8.9046e+09,5.19304e+09,1.82584e+07
20031017,763300,699700,63600,-220769,8.86492e+09,5.13934e+09,1.83823e+07
20031020,764000,701500,62500,84894,8.88099e+09,5.16145e+09,1.84704e+07
20031021,763600,698800,64800,31653,8.88491e+09,5.16892e+09,1.83582e+07
20031022,763400,678900,84500,-256476,8.84434e+09,5.092e+09,1.68889e+07
20031023,766200,633700,132500,50364,8.84936e+09,5.13004e+09,1.52711e+07
20031024,767300,619900,147400,-21995,8.84325e+09,5.12912e+09,1.39663e+07
20031027,768500,579500,189000,90403,8.85843e+09,5.16992e+09,1.20471e+07
20031028,769700,551400,218300,182811,8.89114e+09,5.24994e+09,1.0196e+07
20031029,769800,535000,234800,109414,8.91209e+09,5.28311e+09,9.55395e+06
20031030,768000,560500,207500,36065,8.92467e+09,5.26813e+09,1.10928e+07
20031031,765200,579300,185900,8940,8.92671e+09,5.25953e+09,1.20517e+07
20031103,762100,600600,161500,174905,8.95931e+09,5.291e+09,1.31549e+07
20031104,759000,608000,151000,-29117,8.95763e+09,5.25648e+09,1.36871e+07
20031105,757600,600900,156700,-4288,8.95797e+09,5.24183e+09,1.35543e+07
20031106,756500,624600,131900,49941,8.96131e+09,5.25732e+09,1.4774e+07
20031107,754900,630400,124500,-5324,8.96307e+09,5.22526e+09,1.50875e+07
20031110,756200,634800,121400,-148843,8.93963e+09,5.18672e+09,1.50952e+07
20031111,753100,603900,149200,2139,8.93241e+09,5.16e+09,1.39192e+07
20031112,752400,607300,145100,171913,8.96681e+09,5.22336e+09,1.41967e+07
20031113,752400,612400,140000,17440,8.97162e+09,5.22968e+09,1.44495e+07
20031114,751700,606000,145700,-97099,8.9536e+09,5.1841e+09,1.44426e+07
20031117,753400,579600,173800,-72509,8.94336e+09,5.1624e+09,1.39031e+07
20031118,753700,563400,190300,-122007,8.9181e+09,5.10342e+09,1.28146e+07
20031119,755300,526700,228600,66876,8.93109e+09,5.13847e+09,1.12507e+07
20031120,752800,439100,313700,5605,8.92836e+09,5.06642e+09,7.14285e+06
20031121,750600,396800,353800,-1706,8.92926e+09,5.05054e+09,4.56984e+06
20031124,747600,377200,370400,1774,8.93694e+09,5.11601e+09,3.17431e+06
20031125,746700,394500,352200,64468,8.9465e+09,5.14218e+09,3.93208e+06
20031126,745200,424100,321100,15450,8.94842e+09,5.14956e+09,6.13674e+06
20031128,743500,494700,248800,33292,8.95485e+09,5.14512e+09,1.04149e+07
20031201,740000,608500,131500,201186,8.99306e+09,5.18448e+09,1.5835e+07
20031202,737100,624900,112200,-13343,8.99024e+09,5.15053e+09,1.71128e+07
20031203,733600,630600,103000,-45733,8.97934e+09,5.10871e+09,1.74853e+07
20031204,731700,645800,85900,21263,8.97908e+09,5.10678e+09,1.83984e+07
20031205,731300,631900,99400,-117517,8.95848e+09,5.07281e+09,1.79086e+07
20031208,731700,615700,116000,90601,8.97192e+09,5.09801e+09,1.70358e+07
20031209,725600,591400,134200,-83254,8.9578e+09,4.97661e+09,1.60294e+07
20031210,726800,568800,158000,-95064,8.94098e+09,4.95345e+09,1.47616e+07
20031211,726900,553000,173900,115472,8.96222e+09,5.02013e+09,1.4164e+07
20031212,726400,554400,172000,67374,8.97125e+09,5.0332e+09,1.40985e+07
20031215,727400,548000,179400,-27290,8.96796e+09,5.01065e+09,1.3723e+07
20031216,727200,538200,189000,51614,8.98071e+09,5.01379e+09,1.32747e+07
20031217,726700,529300,197400,-6779,8.98002e+09,5.02874e+09,1.29049e+07
20031218,726600,535600,191000,133960,9.00091e+09,5.08569e+09,1.28093e+07
20031219,725300,548600,176700,-11726,9.00146e+09,5.05247e+09,1.31442e+07
20031222,723900,551600,172300,77688,9.01367e+09,5.06852e+09,1.29555e+07
20031223,721800,582100,139700,22958,9.01676e+09,5.07353e+09,1.45337e+07
20031224,719600,588500,131100,-9248,9.01445e+09,5.05161e+09,1.52125e+07
20031226,720000,592600,127400,35403,9.01811e+09,5.07101e+09,1.54927e+07
20031229,718700,603300,115400,167610,9.04781e+09,5.11986e+09,1.63583e+07
20031230,717600,628600,89000,2572,9.0492e+09,5.12487e+09,1.79066e+07
20031231,717500,646100,71400,-17301,9.04856e+09,5.11166e+09,1.87434e+07
20040102,715800,659000,56800,-51322,9.03899e+09,5.0757e+09,1.95808e+07
20040105,714800,672900,41900,156890,9.06984e+09,5.06949e+09,2.04225e+07
20040106,713300,670600,42700,40947,9.079e+09,5.06002e+09,2.03054e+07
20040107,712000,675800,36200,39610,9.08808e+09,5.04299e+09,2.04213e+07
20040108,713200,668600,44600,123919,9.107e+09,5.05451e+09,1.97379e+07
20040109,713700,655600,58100,-83013,9.09448e+09,5.03819e+09,1.89409e+07
20040112,713300,652800,60500,95954,9.11052e+09,5.05507e+09,1.89164e+07
20040113,712900,641300,71600,-42560,9.10484e+09,5.03844e+09,1.78827e+07
20040114,715500,626600,88900,131522,9.12535e+09,5.0976e+09,1.68905e+07
20040115,716100,623500,92600,-40721,9.11451e+09,5.10096e+09,1.63922e+07
20040116,715400,615200,100200,139774,9.14011e+09,5.13242e+09,1.62914e+07
20040120,714700,615400,99300,39076,9.14636e+09,5.12509e+09,1.63209e+07
20040121,714000,630800,83200,158382,9.16707e+09,5.12791e+09,1.69001e+07
20040122,711400,625700,85700,-41303,9.15841e+09,5.11871e+09,1.68291e+07
20040123,710400,623300,87100,-5723,9.15844e+09,5.09697e+09,1.69942e+07
20040126,710600,622200,88400,130978,9.17934e+09,5.13661e+09,1.72248e+07
20040127,710400,614800,95600,-88362,9.16314e+09,5.09998e+09,1.65003e+07
20040128,708100,596000,112100,-204720,9.12325e+09,5.02849e+09,1.52555e+07
20040129,708200,576700,131500,72016,9.13444e+09,5.03786e+09,1.4581e+07
20040130,708300,551000,157300,338,9.13803e+09,5.04606e+09,1.28833e+07
20040202,705400,480300,225100,83286,9.15259e+09,5.03742e+09,9.6425e+06
20040203,701800,452800,249000,36079,9.16166e+09,5.00154e+09,8.52031e+06
20040204,700400,439000,261400,-11685,9.1581e+09,4.96407e+09,8.34858e+06
20040205,699200,431800,267400,-10630,9.15736e+09,4.97121e+09,8.20488e+06
20040206,698700,427800,270900,46313,9.16424e+09,5.03164e+09,8.23071e+06
20040209,696400,419800,276600,2370,9.16288e+09,5.02382e+09,8.10351e+06
20040210,693300,430100,263200,41772,9.16983e+09,5.01034e+09,8.6912e+06
20040211,690300,460500,229800,111654,9.19072e+09,5.04355e+09,1.03448e+07
20040212,685800,506700,179100,-90586,9.17862e+09,4.97758e+09,1.32412e+07
20040213,684400,522400,162000,-53009,9.1681e+09,4.93719e+09,1.41319e+07
20040217,681500,532000,149500,158976,9.19689e+09,4.96912e+09,1.49483e+07
20040218,681100,547100,134000,-31677,9.1888e+09,4.9492e+09,1.53915e+07
20040219,678900,547200,131700,-54419,9.17715e+09,4.91341e+09,1.53029e+07
20040220,678100,538600,139500,-83323,9.16315e+09,4.88891e+09,1.46992e+07
20040223,678700,544600,134100,-70703,9.15042e+09,4.87175e+09,1.48961e+07
20040224,680000,507400,172600,-25214,9.14096e+09,4.86866e+09,1.30802e+07
20040225,678900,491000,187900,54181,9.15042e+09,4.89424e+09,1.1802e+07
20040226,678600,467500,211100,33868,9.15634e+09,4.91676e+09,1.05958e+07
20040227,678500,459600,218900,78792,9.17096e+09,4.93473e+09,1.01947e+07
20040301,677300,457900,219400,101473,9.18313e+09,4.97297e+09,1.03674e+07
20040302,676000,475800,200200,-80210,9.16991e+09,4.92911e+09,1.12461e+07
20040303,674400,501300,173100,36185,9.17555e+09,4.92818e+09,1.27036e+07
20040304,675600,517200,158400,56165,9.18435e+09,4.97182e+09,1.34007e+07
20040305,674900,524600,150300,90437,9.19862e+09,4.98878e+09,1.4079e+07
20040308,674900,538000,136900,-59385,9.19172e+09,4.95413e+09,1.42507e+07
20040309,675400,527900,147500,-84385,9.17879e+09,4.92325e+09,1.37918e+07
20040310,677200,486300,190900,-147348,9.15504e+09,4.86286e+09,1.1099e+07
20040311,682900,431700,251200,-109090,9.13696e+09,4.84313e+09,7.94936e+06
20040312,684300,403500,280800,33001,9.14396e+09,4.92486e+09,6.016e+06
20040315,684700,349500,335200,65448,9.15608e+09,4.86085e+09,2.18e+06
20040316,685400,302700,382700,-27098,9.15159e+09,4.88919e+09,-933025
20040317,684800,291900,392900,-65929,9.13933e+09,4.9631e+09,-1.76331e+06
20040318,684700,308300,376400,31829,9.14557e+09,4.95808e+09,-755188
20040319,684400,309500,374900,42952,9.15434e+09,4.91203e+09,-572932
20040322,684800,310500,374300,28052,9.16207e+09,4.84969e+09,-184351
20040323,683700,307200,376500,13423,9.16433e+09,4.84581e+09,-211784
20040324,685500,269300,416200,-14840,9.16204e+09,4.85438e+09,-2.13047e+06
20040325,686000,237700,448300,-116739,9.13854e+09,4.92371e+09,-4.02313e+06
20040326,686100,226700,459400,16503,9.14165e+09,4.92986e+09,-4.60974e+06
20040329,685200,269000,416200,-45403,9.13167e+09,4.98234e+09,-1.89821e+06
20040330,683700,343200,340500,55498,9.14436e+09,4.99913e+09,1.86525e+06
20040331,679900,449200,230700,-15640,9.14101e+09,4.97959e+09,8.00425e+06
20040401,673800,520200,153600,117663,9.16436e+09,4.96373e+09,1.26364e+07
20040402,671300,575300,96000,150968,9.19255e+09,4.97822e+09,1.63526e+07
20040405,667100,601400,65700,119085,9.21753e+09,4.9702e+09,1.7979e+07
20040406,665900,610500,55400,-58346,9.20904e+09,4.95117e+09,1.84705e+07
20040407,665600,610000,55600,-66426,9.19625e+09,4.92706e+09,1.82516e+07
20040408,666400,596500,69900,-3104,9.19741e+09,4.91463e+09,1.73041e+07
20040412,666500,591900,74600,131288,9.2221e+09,4.92931e+09,1.70605e+07
20040413,667800,571300,96500,-263268,9.17531e+09,4.86353e+09,1.58491e+07
20040414,670500,547300,123200,-22041,9.17279e+09,4.86257e+09,1.453e+07
20040415,671200,531600,139600,3031,9.17442e+09,4.87415e+09,1.38142e+07
20040416,672800,505000,167800,57782,9.18473e+09,4.92419e+09,1.25782e+07
20040419,675100,453900,221200,52453,9.19677e+09,4.94558e+09,1.02738e+07
20040420,677400,408700,268700,-41588,9.18744e+09,4.88878e+09,7.67702e+06
20040421,677500,388700,288800,69875,9.20263e+09,4.91262e+09,6.57064e+06
20040422,676500,394100,282400,160990,9.23507e+09,4.99497e+09,7.32691e+06
20040423,675200,389500,285700,-25260,9.22661e+09,4.9721e+09,7.04207e+06
20040426,674700,394000,280700,2711,9.22774e+09,4.9527e+09,7.06277e+06
20040427,674100,407700,266400,63350,9.24166e+09,4.96895e+09,7.76428e+06
20040428,674000,416900,257100,-77955,9.22665e+09,4.91232e+09,8.2882e+06
20040429,675400,387800,287600,-18831,9.22168e+09,4.8742e+09,6.21455e+06
20040430,675300,374600,300700,20618,9.22565e+09,4.85224e+09,4.55945e+06
20040503,675000,357900,317100,57966,9.2358e+09,4.88708e+09,3.53848e+06
20040504,675400,340600,334800,-5276,9.23803e+09,4.89536e+09,2.44776e+06
20040505,675000,335000,340000,11106,9.23886e+09,4.90131e+09,2.20486e+06
20040506,675200,338900,336300,-16076,9.23394e+09,4.85639e+09,2.17394e+06
20040507,674800,334200,340600,30449,9.23629e+09,4.7645e+09,1.36016e+06
20040510,677500,290500,387000,1040,9.23371e+09,4.71984e+09,-914502
20040511,679000,253000,426000,-62776,9.22385e+09,4.76728e+09,-3.18616e+06
20040512,681900,225600,456300,321,9.22471e+09,4.79984e+09,-5.05934e+06
20040513,682600,195400,487200,17673,9.22609e+09,4.80353e+09,-7.19172e+06
20040514,682500,199300,483200,-2905,9.22476e+09,4.81186e+09,-7.07541e+06
20040517,682400,199500,482900,64212,9.23878e+09,4.72558e+09,-7.2577e+06
20040518,683600,195200,488400,-71570,9.23254e+09,4.77273e+09,-7.23953e+06
20040519,683300,195800,487500,24093,9.23857e+09,4.7641e+09,-7.10235e+06
20040520,683300,199300,484000,16231,9.24349e+09,4.76284e+09,-6.59073e+06
20040521,682500,223900,458600,24488,9.25149e+09,4.77636e+09,-5.04049e+06
20040524,683800,291600,392200,-11665,9.25095e+09,4.81839e+09,-1.53181e+06
20040525,683500,364800,318700,40028,9.25523e+09,4.88844e+09,2.99973e+06
20040526,682100,465900,216200,41231,9.26304e+09,4.87143e+09,8.36974e+06
20040527,682400,536200,146200,67910,9.27415e+09,4.88208e+09,1.2542e+07
20040528,682100,572800,109300,51404,9.28435e+09,4.89606e+09,1.55653e+07
20040601,681100,587800,93300,29387,9.28989e+09,4.90091e+09,1.68804e+07
20040602,680200,603600,76600,66361,9.30244e+09,4.91589e+09,1.78437e+07
20040603,681100,608000,73100,-203049,9.26695e+09,4.87522e+09,1.79156e+07
20040604,680700,613200,67500,99219,9.28688e+09,4.88879e+09,1.84694e+07
20040607,680700,628100,52600,325166,9.34527e+09,4.96503e+09,1.94768e+07
20040608,680800,632500,48300,6814,9.34684e+09,4.97222e+09,1.982e+07
20040609,680900,639000,41900,-243749,9.30384e+09,4.91304e+09,2.00592e+07
20040610,680500,654700,25800,91640,9.31985e+09,4.92972e+09,2.08082e+07
20040614,680600,648900,31700,-230936,9.27946e+09,4.87837e+09,2.0329e+07
20040615,681700,641100,40600,181294,9.31262e+09,4.92376e+09,1.98197e+07
20040616,683900,617200,66700,31948,9.32566e+09,4.91462e+09,1.86498e+07
20040617,686600,590800,95800,44929,9.33389e+09,4.93466e+09,1.75032e+07
20040618,687600,566900,120700,20775,9.33131e+09,4.95042e+09,1.57619e+07
20040621,688100,558700,129400,-55255,9.32233e+09,4.91487e+09,1.49926e+07
20040622,688300,546300,142000,4114,9.32599e+09,4.91013e+09,1.4167e+07
20040623,687300,547900,139400,154407,9.35598e+09,4.95475e+09,1.43062e+07
20040624,687400,546700,140700,-25511,9.34898e+09,4.95306e+09,1.44325e+07
20040625,685900,545600,140300,40214,9.35739e+09,4.94468e+09,1.48267e+07
20040628,685200,570400,114800,-72372,9.34679e+09,4.91965e+09,1.56061e+07
20040629,684800,567700,117100,20465,9.35094e+09,4.91973e+09,1.52326e+07
20040630,684100,575500,108600,133950,9.37288e+09,4.95053e+09,1.57311e+07
20040701,684500,565400,119100,-143259,9.34858e+09,4.89994e+09,1.48411e+07
20040702,684800,557000,127800,-19055,9.34375e+09,4.88851e+09,1.42316e+07
20040706,684900,536100,148800,-93037,9.3252e+09,4.85645e+09,1.29347e+07
20040707,685100,522200,162900,53182,9.33376e+09,4.87374e+09,1.21465e+07
20040708,688200,469200,219000,-84624,9.31967e+09,4.85155e+09,9.08601e+06
20040709,689800,440400,249400,38935,9.32598e+09,4.8777e+09,8.09539e+06
20040712,692800,401500,291300,39629,9.33246e+09,4.89979e+09,6.03295e+06
20040713,692600,400200,292400,-9122,9.33174e+09,4.89826e+09,6.01536e+06
20040714,692300,379400,312900,135008,9.35438e+09,4.87803e+09,4.9368e+06
20040715,691500,386000,305500,36277,9.35852e+09,4.87324e+09,5.32853e+06
20040716,692100,377500,314600,131850,9.38022e+09,4.85397e+09,4.91666e+06
20040719,692100,364700,327400,26297,9.38836e+09,4.85402e+09,3.97875e+06
20040720,690100,352200,337900,-91860,9.37038e+09,4.88288e+09,3.02618e+06
20040721,695100,357600,337500,50279,9.37577e+09,4.82712e+09,2.6279e+06
20040722,694800,347000,347800,-105630,9.35911e+09,4.8228e+09,2.04318e+06
20040723,695100,338600,356500,52349,9.37247e+09,4.78934e+09,1.25593e+06
20040726,695800,332200,363600,26512,9.37787e+09,4.76333e+09,606282
20040727,696900,308600,388300,-39397,9.36835e+09,4.82017e+09,-1.1693e+06
20040728,696500,296700,399800,22721,9.36843e+09,4.82269e+09,-1.77153e+06
20040729,696600,315300,381300,-14743,9.36393e+09,4.86415e+09,-946602
20040730,694000,351900,342100,-27688,9.35923e+09,4.86311e+09,1.16048e+06
20040802,692700,378800,313900,53128,9.36308e+09,4.85437e+09,3.399e+06
20040803,692000,417100,274900,-23131,9.35785e+09,4.81724e+09,5.97591e+06
20040804,690800,448800,242000,1814,9.35698e+09,4.79995e+09,8.41676e+06
20040805,692200,443200,249000,-106440,9.33535e+09,4.72402e+09,7.91101e+06
20040806,693800,415800,278000,-69423,9.31911e+09,4.66916e+09,6.15459e+06
20040809,697900,343900,354000,-545,9.32052e+09,4.7096e+09,1.69678e+06
20040810,699900,313900,386000,-3016,9.32018e+09,4.78408e+09,-507725
20040811,702000,299400,402600,55936,9.32859e+09,4.78459e+09,-1.62614e+06
20040812,703800,281600,422200,107710,9.34667e+09,4.73743e+09,-2.70616e+06
20040813,706500,270000,436500,-5605,9.34728e+09,4.7585e+09,-2.57573e+06
20040816,706500,293600,412900,-66098,9.34018e+09,4.81536e+09,-1.22402e+06
20040817,706100,325400,380700,12872,9.34287e+09,4.81621e+09,726835
20040818,704800,347700,357100,-36731,9.33674e+09,4.86346e+09,2.46409e+06
20040819,705300,410000,295300,-21886,9.33175e+09,4.83796e+09,6.08931e+06
20040820,704200,489400,214800,107716,9.35033e+09,4.87288e+09,9.92591e+06
20040823,705200,539600,165600,-44128,9.34229e+09,4.85948e+09,1.24868e+07
20040824,705800,554300,151500,20044,9.34237e+09,4.86065e+09,1.33251e+07
20040825,705700,567200,138500,129135,9.36669e+09,4.8945e+09,1.43561e+07
20040826,706300,587900,118400,-8617,9.3676e+09,4.896e+09,1.5162e+07
20040827,707600,601700,105900,27080,9.37279e+09,4.91435e+09,1.61324e+07
20040830,707800,613400,94400,-146031,9.34116e+09,4.87464e+09,1.68528e+07
20040831,706900,623300,83600,110829,9.36054e+09,4.89744e+09,1.75146e+07
20040901,705300,635400,69900,97634,9.37706e+09,4.9098e+09,1.83963e+07
20040902,705300,641100,64200,217176,9.41876e+09,4.96324e+09,1.89747e+07
20040903,705600,637700,67900,-48960,9.40844e+09,4.94844e+09,1.89094e+07
20040907,706500,640100,66400,119864,9.42847e+09,4.98487e+09,1.92937e+07
20040908,705800,643200,62600,-125757,9.40974e+09,4.9459e+09,1.9399e+07
20040909,706200,653000,53200,15634,9.41102e+09,4.95528e+09,1.96329e+07
20040910,706300,653200,53100,98929,9.42742e+09,4.97743e+09,1.97112e+07
20040913,704400,670900,33500,28801,9.42829e+09,4.9714e+09,2.02408e+07
20040914,704700,660500,44200,42287,9.43918e+09,4.98105e+09,2.00827e+07
20040915,706800,658200,48600,-107986,9.41883e+09,4.97763e+09,1.96591e+07
20040916,707500,653500,54000,136937,9.44403e+09,5.0162e+09,1.96186e+07
20040917,707600,652900,54700,69154,9.45768e+09,5.03397e+09,1.96923e+07
20040920,707800,637300,70500,-58419,9.44853e+09,5.01359e+09,1.89142e+07
20040921,708100,627300,80800,159740,9.47958e+09,5.05195e+09,1.86105e+07
20040922,708600,622600,86000,-246629,9.43404e+09,4.99634e+09,1.7891e+07
20040923,709400,601700,107700,-45329,9.42795e+09,4.98138e+09,1.64299e+07
20040924,710700,569600,141100,53776,9.43768e+09,5.00848e+09,1.52899e+07
20040927,711100,532000,179100,-88510,9.42033e+09,4.98126e+09,1.33918e+07
20040928,710900,513200,197700,66803,9.43308e+09,5.00706e+09,1.09564e+07
20040929,709100,498600,210500,59293,9.44432e+09,5.01011e+09,1.02774e+07
20040930,709300,486400,222900,80979,9.45933e+09,5.04286e+09,9.73209e+06
20041001,707300,498600,208700,134537,9.48462e+09,5.09663e+09,1.08168e+07
20041004,705100,542300,162800,79394,9.49909e+09,5.09899e+09,1.37472e+07
20041005,700400,559800,140600,13536,9.50226e+09,5.05862e+09,1.48583e+07
20041006,697400,582500,114900,137688,9.52655e+09,5.07386e+09,1.6135e+07
20041007,695800,604500,91300,-153061,9.49598e+09,5.01395e+09,1.71829e+07
20041008,695800,610200,85600,-167705,9.47068e+09,4.95821e+09,1.73867e+07
20041011,696700,589600,107100,28363,9.4768e+09,4.97368e+09,1.64789e+07
20041012,696900,572900,124000,-49495,9.47021e+09,4.95992e+09,1.58333e+07
20041013,697500,554700,142800,-118360,9.4504e+09,4.92105e+09,1.43947e+07
20041014,698400,515800,182600,39457,9.46241e+09,4.90392e+09,1.18574e+07
20041015,701200,499000,202200,160615,9.48672e+09,4.93777e+09,1.04272e+07
20041018,702800,469500,233300,143028,9.50788e+09,4.94471e+09,8.46896e+06
20041019,703900,440100,263800,33430,9.51596e+09,4.91474e+09,6.45448e+06
20041020,703400,426200,277200,-21562,9.51606e+09,4.92762e+09,5.56809e+06
20041021,702100,425600,276500,123153,9.53278e+09,4.95469e+09,6.24486e+06
20041022,702300,417100,285200,-48121,9.53159e+09,4.92798e+09,5.59983e+06
20041025,703700,396000,307700,83810,9.55205e+09,4.95844e+09,4.45788e+06
20041026,703200,402500,300700,-23405,9.54404e+09,5.02618e+09,4.7881e+06
20041027,701800,424900,276900,118456,9.56478e+09,5.07287e+09,6.46892e+06
20041028,700500,444700,255800,14704,9.5667e+09,5.05969e+09,8.09307e+06
20041029,697700,478800,218900,33785,9.57359e+09,5.05735e+09,1.09682e+07
20041101,694400,515300,179100,31236,9.57853e+09,5.04414e+09,1.35755e+07
20041102,692900,521200,171700,7824,9.57994e+09,5.02788e+09,1.3675e+07
20041103,692700,562700,130000,125010,9.60904e+09,5.07544e+09,1.54428e+07
20041104,691200,574100,117100,275721,9.65777e+09,5.14804e+09,1.6618e+07
20041105,689800,601200,88600,52159,9.66801e+09,5.14303e+09,1.83499e+07
20041108,687500,613200,74300,14791,9.6725e+09,5.11671e+09,1.89314e+07
20041109,686400,635800,50600,34268,9.68152e+09,5.10722e+09,1.98781e+07
20041110,684600,645400,39200,19653,9.6844e+09,5.11286e+09,2.03275e+07
20041111,684700,643000,41700,199635,9.72284e+09,5.15538e+09,2.02837e+07
20041112,684500,651200,33300,182082,9.75517e+09,5.19888e+09,2.09424e+07
20041115,683800,648400,35400,21971,9.75803e+09,5.19449e+09,2.08202e+07
20041116,683600,646900,36700,-178058,9.72504e+09,5.14971e+09,2.06321e+07
20041117,683000,650900,32100,71053,9.73719e+09,5.16172e+09,2.09177e+07
20041118,682700,653600,29100,23162,9.74427e+09,5.16471e+09,2.07883e+07
20041119,681400,644700,36700,-227499,9.70343e+09,5.10981e+09,2.00561e+07
20041122,681800,635500,46300,180366,9.73725e+09,5.16132e+09,2.00076e+07
20041123,681300,626600,54700,67416,9.74895e+09,5.17051e+09,1.93203e+07
20041124,680000,616400,63600,123777,9.76893e+09,5.19327e+09,1.89116e+07
20041126,679200,604600,74600,27569,9.77291e+09,5.19644e+09,1.84435e+07
20041129,679600,598800,80800,-45176,9.76584e+09,5.18321e+09,1.79134e+07
20041130,679100,589600,89500,-51141,9.75575e+09,5.16079e+09,1.78714e+07
20041201,677100,589100,88000,196233,9.79356e+09,5.19542e+09,1.81384e+07
20041202,677200,582300,94900,-88923,9.7764e+09,5.17821e+09,1.77122e+07
20041203,676200,575200,101000,35185,9.78537e+09,5.18249e+09,1.71031e+07
20041206,676100,581100,95000,-7889,9.78507e+09,5.17766e+09,1.72291e+07
20041207,674000,577000,97000,-209001,9.74767e+09,5.09303e+09,1.71033e+07
20041208,673600,572200,101400,94743,9.76437e+09,5.1155e+09,1.63508e+07
20041209,672300,556000,116300,84651,9.78001e+09,5.13268e+09,1.52965e+07
20041210,671500,538500,133000,47299,9.79015e+09,5.13332e+09,1.40161e+07
20041213,670800,524100,146700,120148,9.81201e+09,5.17215e+09,1.33845e+07
20041214,668900,524200,144700,58754,9.82514e+09,5.18427e+09,1.38787e+07
20041215,662900,527900,135000,72703,9.83301e+09,5.17295e+09,1.45237e+07
20041216,662700,534900,127800,-54398,9.82238e+09,5.14643e+09,1.52003e+07
20041217,660600,554100,106500,-35422,9.81842e+09,5.11652e+09,1.61867e+07
20041220,659500,561600,97900,-11147,9.81702e+09,5.10104e+09,1.6875e+07
20041221,657900,555000,102900,84413,9.82582e+09,5.13069e+09,1.66963e+07
20041222,657000,546600,110400,28844,9.83167e+09,5.13713e+09,1.62113e+07
20041223,655100,551100,104000,7242,9.83195e+09,5.11612e+09,1.64726e+07
20041227,654300,551600,102700,-94689,9.81628e+09,5.08463e+09,1.64832e+07
20041228,653400,585000,68400,190833,9.85218e+09,5.12773e+09,1.84375e+07
20041229,651700,585900,65800,11886,9.85354e+09,5.12061e+09,1.87945e+07
20041230,650800,585400,65400,24535,9.85782e+09,5.1085e+09,1.91239e+07
20041231,650700,592600,58100,-21075,9.85298e+09,5.10261e+09,1.94742e+07
20050103,649400,586100,63300,-263927,9.80733e+09,5.02646e+09,1.86757e+07
20050104,647900,576500,71400,-249493,9.75727e+09,4.95459e+09,1.77718e+07
20050105,648700,523600,125100,-105233,9.73702e+09,4.91626e+09,1.45367e+07
20050106,649900,456000,193900,49392,9.74806e+09,4.94381e+09,9.19228e+06
20050107,649400,358400,291000,16791,9.75426e+09,4.9172e+09,2.33758e+06
20050110,647900,304000,343900,6697,9.75741e+09,4.93499e+09,-789519
20050111,645800,269200,376600,35342,9.76377e+09,4.89901e+09,-2.49615e+06
20050112,643400,271900,371500,-36842,9.75761e+09,4.89263e+09,-2.20784e+06
20050113,643500,246900,396600,9898,9.75992e+09,4.87269e+09,-3.19045e+06
20050114,643400,250900,392500,-28787,9.75586e+09,4.9111e+09,-2.58373e+06
20050118,642200,271400,370800,5379,9.7555e+09,4.94758e+09,-918696
20050119,639200,291200,348000,30441,9.76052e+09,4.88317e+09,410473
20050120,638000,324000,314000,8560,9.76184e+09,4.82496e+09,2.10138e+06
20050121,638200,331900,306300,12871,9.76311e+09,4.79655e+09,2.48857e+06
20050124,638900,325200,313700,49236,9.77216e+09,4.77246e+09,2.04394e+06
20050125,639800,308000,331800,438,9.77187e+09,4.78486e+09,641125
20050126,639800,303900,335900,-6164,9.77194e+09,4.82041e+09,734100
20050127,639800,315900,323900,47843,9.77686e+09,4.83079e+09,1.25086e+06
20050128,639600,322400,317200,9966,9.77804e+09,4.81404e+09,1.84822e+06
20050131,637000,356400,280600,30133,9.78409e+09,4.84701e+09,4.01207e+06
20050201,634700,403700,231000,93802,9.80039e+09,4.87019e+09,7.45709e+06
20050202,633900,418900,215000,58538,9.81121e+09,4.88584e+09,9.15204e+06
20050203,632700,424800,207900,6765,9.81205e+09,4.86194e+09,1.00637e+07
20050204,631200,471400,159800,155641,9.83727e+09,4.91224e+09,1.27174e+07
20050207,629600,488300,141300,-41127,9.82824e+09,4.89616e+09,1.37075e+07
20050208,628500,518100,110400,30377,9.8334e+09,4.89562e+09,1.54746e+07
20050209,629100,509600,119500,-140403,9.81012e+09,4.85687e+09,1.50753e+07
20050210,628700,507600,121100,114960,9.82919e+09,4.882e+09,1.50414e+07
20050211,628300,514100,114200,127827,9.85676e+09,4.91299e+09,1.57474e+07
20050214,630500,493800,136700,-12868,9.85571e+09,4.92441e+09,1.49058e+07
20050215,630100,491200,138900,42730,9.86328e+09,4.93881e+09,1.4924e+07
20050216,630200,512900,117300,44392,9.87221e+09,4.95015e+09,1.62675e+07
20050217,630700,532300,98400,-143028,9.84235e+09,4.90992e+09,1.70937e+07
20050218,630900,531400,99500,652,9.83883e+09,4.91452e+09,1.69698e+07
20050222,632300,513200,119100,-257858,9.79179e+09,4.84415e+09,1.53956e+07
20050223,633800,488100,145700,77027,9.80889e+09,4.87861e+09,1.37101e+07
20050224,635300,453100,182200,135059,9.83333e+09,4.94252e+09,1.1599e+07
20050225,636100,430800,205300,169113,9.86386e+09,5.00369e+09,1.04748e+07
20050228,637400,417800,219600,-51377,9.85578e+09,4.98683e+09,9.05451e+06
20050301,636400,440500,195900,45019,9.86624e+09,5.0092e+09,1.04018e+07
20050302,635800,465400,170400,-27616,9.85653e+09,4.999e+09,1.20995e+07
20050303,634300,483700,150600,50224,9.86627e+09,5.00034e+09,1.33422e+07
20050304,633100,494200,138900,181633,9.90001e+09,5.047e+09,1.47199e+07
20050307,631500,514600,116900,46199,9.90966e+09,5.04386e+09,1.60937e+07
20050308,631400,514000,117400,-85475,9.89378e+09,5.01532e+09,1.66079e+07
20050309,632000,505400,126600,-172095,9.86233e+09,4.96773e+09,1.59033e+07
20050310,632000,510100,121900,4234,9.8637e+09,4.97247e+09,1.62703e+07
20050311,631700,499500,132200,-63124,9.85248e+09,4.94731e+09,1.53485e+07
20050314,632500,485400,147100,67766,9.85571e+09,4.99692e+09,1.44983e+07
20050315,632500,467600,164900,-58981,9.84434e+09,4.96973e+09,1.319e+07
20050316,632900,449000,183900,-158999,9.81692e+09,4.91831e+09,1.1679e+07
20050317,633500,436900,196600,52317,9.82836e+09,4.94282e+09,1.06806e+07
20050318,633600,428400,205200,-26329,9.82361e+09,4.93848e+09,9.95254e+06
20050321,635200,390600,244600,-36570,9.81632e+09,4.92682e+09,7.22086e+06
20050322,637700,343100,294600,-28824,9.81312e+09,4.90814e+09,3.98158e+06
20050323,639000,312900,326100,-48310,9.80472e+09,4.9025e+09,957969
20050324,639400,281400,358000,12993,9.80582e+09,4.91603e+09,-1.69529e+06
20050328,638700,257500,381200,-5843,9.80608e+09,4.91058e+09,-3.78477e+06
20050329,639800,215000,424800,74170,9.82138e+09,4.86703e+09,-6.84015e+06
20050330,638900,215300,423600,-67416,9.80513e+09,4.91804e+09,-6.94755e+06
20050331,638700,226300,412400,3259,9.80657e+09,4.91574e+09,-5.86672e+06
20050401,638200,257200,381000,-11406,9.79908e+09,4.89414e+09,-4.2587e+06
20050404,637400,296200,341200,29110,9.80419e+09,4.90117e+09,-836576
20050405,636800,358300,278500,17510,9.80764e+09,4.91246e+09,2.78765e+06
20050406,635700,386300,249400,5693,9.80923e+09,4.92199e+09,5.12012e+06
20050407,634500,400900,233600,19481,9.81381e+09,4.93279e+09,6.19775e+06
20050408,634300,421600,212700,-58076,9.80146e+09,4.88443e+09,7.70521e+06
20050411,634200,430500,203700,41498,9.81071e+09,4.88033e+09,8.48164e+06
20050412,634500,459800,174700,95587,9.82773e+09,4.91552e+09,1.04987e+07
20050413,634800,457500,177300,-86518,9.81293e+09,4.84562e+09,1.00374e+07
20050414,636700,424500,212200,-49817,9.80754e+09,4.79648e+09,8.20411e+06
20050415,639700,385600,254100,7608,9.81444e+09,4.72357e+09,5.44824e+06
20050418,641800,347800,294000,-35779,9.80699e+09,4.76676e+09,2.152e+06
20050419,644400,299700,344700,-76615,9.79379e+09,4.829e+09,-1.54472e+06
20050420,646500,250800,395700,100644,9.81315e+09,4.77711e+09,-4.20558e+06
20050421,646700,244800,401900,-161981,9.78665e+09,4.87603e+09,-4.70966e+06
20050422,645200,260400,384800,115782,9.80503e+09,4.82501e+09,-3.91089e+06
20050425,646900,283600,363300,-30066,9.79942e+09,4.88548e+09,-2.23265e+06
20050426,646900,297600,349300,53146,9.80884e+09,4.84514e+09,-1.57917e+06
20050427,646400,328100,318300,19676,9.81757e+09,4.84683e+09,722842
20050428,646800,322100,324700,38303,9.82199e+09,4.79011e+09,383711
20050429,646100,331900,314200,65059,9.83441e+09,4.84163e+09,1.13752e+06
20050502,646700,324700,322000,-5422,9.83162e+09,4.87001e+09,1.13976e+06
20050503,645200,328100,317100,51207,9.83942e+09,4.85091e+09,2.00745e+06
20050504,644200,365100,279100,29738,9.84734e+09,4.90642e+09,4.48582e+06
20050505,642700,426700,216000,-8040,9.84631e+09,4.88876e+09,7.93091e+06
20050506,641700,471700,170000,10290,9.84731e+09,4.89186e+09,1.05446e+07
20050509,640600,499000,141600,100000,9.8677e+09,4.91096e+09,1.27525e+07
20050510,641400,523800,117600,-110734,9.84605e+09,4.86845e+09,1.455e+07
20050511,639200,525400,113800,85772,9.86099e+09,4.88243e+09,1.49452e+07
20050512,639700,522800,116900,-148745,9.8337e+09,4.82123e+09,1.44253e+07
20050513,641000,505900,135100,-45001,9.82653e+09,4.79546e+09,1.31141e+07
20050516,643600,485500,158100,192635,9.86851e+09,4.86962e+09,1.14945e+07
20050517,644200,487400,156800,74656,9.88047e+09,4.9184e+09,1.13601e+07
20050518,643700,497700,146000,159970,9.90953e+09,4.98334e+09,1.22163e+07
20050519,643000,515500,127500,-6694,9.90789e+09,4.98574e+09,1.36425e+07
20050520,642700,540700,102000,13009,9.90895e+09,4.97711e+09,1.50834e+07
20050523,642600,565800,76800,73519,9.92372e+09,4.99984e+09,1.68806e+07
20050524,642700,576600,66100,-59558,9.90677e+09,4.99478e+09,1.78e+07
20050525,642900,591900,51000,-100587,9.88805e+09,4.97034e+09,1.87826e+07
20050526,643000,592000,51000,133206,9.91307e+09,4.99361e+09,1.89119e+07
20050527,642300,595100,47200,53673,9.92383e+09,5.00099e+09,1.95523e+07
20050531,642200,589300,52900,-73050,9.91745e+09,4.96111e+09,1.91109e+07
20050601,639800,582300,57500,174059,9.95094e+09,4.99761e+09,1.94827e+07
20050602,639800,592000,47800,17160,9.9497e+09,5.00044e+09,1.9936e+07
20050603,639200,596100,43100,-102805,9.93007e+09,4.9722e+09,1.99414e+07
20050606,639900,594100,45800,48566,9.94147e+09,4.9879e+09,1.99033e+07
20050607,638400,588300,50100,-18231,9.93524e+09,4.98547e+09,1.98484e+07
20050608,638600,578900,59700,-49260,9.92555e+09,4.97265e+09,1.91903e+07
20050609,639000,566800,72200,127643,9.94946e+09,5.00085e+09,1.87115e+07
20050610,639200,555500,83700,-18896,9.94575e+09,5.00097e+09,1.79603e+07
20050613,639400,542400,97000,48664,9.95987e+09,4.98836e+09,1.69368e+07
20050614,639300,531500,107800,71078,9.97442e+09,5.00735e+09,1.61492e+07
20050615,638800,539300,99500,44697,9.98229e+09,5.01549e+09,1.61934e+07
20050616,637800,549200,88600,36627,9.98944e+09,5.02693e+09,1.66199e+07
20050617,636800,554700,82100,112667,1.00079e+10,5.04783e+09,1.73126e+07
20050620,635400,552600,82800,-23973,1.00067e+10,5.03991e+09,1.75366e+07
20050621,634600,556200,78400,-89334,9.99561e+09,4.99381e+09,1.75468e+07
20050622,633800,565100,68700,38300,1.00026e+10,4.99351e+09,1.80751e+07
20050623,633800,556800,77000,-129147,9.97915e+09,4.94122e+09,1.73306e+07
20050624,634300,542300,92000,-95393,9.96239e+09,4.90955e+09,1.62639e+07
20050627,635400,506300,129100,-6389,9.95834e+09,4.90095e+09,1.39856e+07
20050628,634800,485200,149600,109309,9.97761e+09,4.94892e+09,1.23103e+07
20050629,635000,457800,177200,22832,9.98217e+09,4.94796e+09,1.10086e+07
20050630,633400,442800,190600,-26528,9.97727e+09,4.91776e+09,1.02244e+07
20050701,633300,437800,195500,43623,9.9883e+09,4.92527e+09,1.00333e+07
20050705,631300,443400,187900,122443,1.00096e+10,4.95933e+09,1.08293e+07
20050706,630900,436200,194700,-67352,9.99827e+09,4.91035e+09,1.03233e+07
20050707,630600,438200,192400,73147,1.00132e+10,4.91739e+09,1.03737e+07
20050708,628700,460600,168100,105137,1.00348e+10,4.95511e+09,1.15134e+07
20050711,627300,489100,138200,104645,1.00545e+10,4.98371e+09,1.31674e+07
20050712,625100,501500,123600,36598,1.00603e+10,4.97593e+09,1.41699e+07
20050713,624100,522800,101300,-16099,1.00542e+10,4.9669e+09,1.55734e+07
20050714,623100,548200,74900,-92307,1.00328e+10,4.94656e+09,1.74168e+07
20050715,620900,562900,58000,59952,1.00456e+10,4.94227e+09,1.83655e+07
20050718,620800,564200,56600,-28429,1.00382e+10,4.93788e+09,1.83172e+07
20050719,620700,570100,50600,187764,1.00746e+10,4.98292e+09,1.90995e+07
20050720,619300,580800,38500,172018,1.01039e+10,5.01015e+09,1.99127e+07
20050721,619300,583400,35900,-162976,1.00746e+10,4.96954e+09,1.99933e+07
20050722,618000,580600,37400,133919,1.00974e+10,5.00082e+09,1.99505e+07
20050725,618200,571800,46400,-86378,1.00826e+10,4.98525e+09,1.92515e+07
20050726,617100,571900,45200,63819,1.0093e+10,4.99288e+09,1.94278e+07
20050727,616700,569500,47200,126933,1.01237e+10,5.00836e+09,1.94102e+07
20050728,615400,561400,54000,183559,1.01553e+10,5.03558e+09,1.91852e+07
20050729,612400,548500,63900,-104622,1.01366e+10,4.97795e+09,1.84194e+07
20050801,611700,544500,67200,14400,1.01396e+10,4.97554e+09,1.80198e+07
20050802,610500,544600,65900,131034,1.01665e+10,4.99932e+09,1.83564e+07
20050803,609800,535500,74300,28157,1.01749e+10,4.98638e+09,1.79947e+07
20050804,614100,516200,97900,-172391,1.0138e+10,5.0018e+09,1.67709e+07
20050805,614200,502800,111400,-172920,1.01052e+10,4.94783e+09,1.54977e+07
20050808,615400,464200,151200,-42545,1.00984e+10,4.93538e+09,1.30546e+07
20050809,614700,423700,191000,6645,1.01045e+10,4.94227e+09,1.04604e+07
20050810,615500,392600,222900,45702,1.01128e+10,4.94959e+09,7.9567e+06
20050811,616500,368500,248000,60215,1.01236e+10,4.98782e+09,6.57055e+06
20050812,616300,360900,255400,-32041,1.01166e+10,4.97289e+09,6.07179e+06
20050815,615700,372200,243500,6169,1.01213e+10,4.97562e+09,6.9142e+06
20050816,614900,367500,247400,-116864,1.01008e+10,4.90301e+09,6.4334e+06
20050817,617800,367700,250100,-46241,1.00931e+10,4.93473e+09,6.35065e+06
20050818,617700,337000,280700,5874,1.00938e+10,4.92013e+09,4.28406e+06
20050819,616900,321100,295800,53380,1.01028e+10,4.92526e+09,3.2115e+06
20050822,614000,305300,308700,10432,1.01047e+10,4.89614e+09,1.73703e+06
20050823,613300,311100,302200,18532,1.0112e+10,4.87126e+09,2.20346e+06
20050824,612400,306300,306100,-13750,1.01087e+10,4.84515e+09,1.69022e+06
20050825,611800,315800,296000,9261,1.01131e+10,4.8421e+09,2.51807e+06
20050826,612000,319500,292500,6070,1.01136e+10,4.80859e+09,2.65598e+06
20050829,611700,324000,287700,-1212,1.01163e+10,4.80958e+09,3.027e+06
20050830,610600,323000,287600,34137,1.01229e+10,4.78973e+09,2.89697e+06
20050831,610000,352500,257500,58715,1.01326e+10,4.85871e+09,4.98504e+06
20050901,608700,361600,247100,97224,1.01494e+10,4.85761e+09,5.84544e+06
20050902,607200,379900,227300,-77585,1.01299e+10,4.78922e+09,7.1665e+06
20050906,607300,412200,195100,128143,1.01575e+10,4.84787e+09,9.1364e+06
20050907,605600,444600,161000,1530,1.01614e+10,4.85724e+09,1.13612e+07
20050908,607400,449400,158000,-14443,1.01591e+10,4.86531e+09,1.17237e+07
20050909,605800,470600,135200,146997,1.01868e+10,4.89612e+09,1.33235e+07
20050912,605700,507200,98500,10902,1.01934e+10,4.89283e+09,1.59448e+07
20050913,606200,515500,90700,-100368,1.01736e+10,4.86206e+09,1.63057e+07
20050914,605800,516000,89800,-45798,1.01639e+10,4.83704e+09,1.62465e+07
20050915,605400,511200,94200,-1637,1.01673e+10,4.81822e+09,1.61218e+07
20050916,605600,502100,103500,103676,1.01857e+10,4.85409e+09,1.55237e+07
20050919,606600,491700,114900,-66706,1.01759e+10,4.83382e+09,1.47362e+07
20050920,607500,463600,143900,-71283,1.01638e+10,4.79793e+09,1.30965e+07
20050921,609900,429800,180100,-93765,1.01457e+10,4.76604e+09,1.02737e+07
20050922,611600,396200,215400,-32534,1.01376e+10,4.79849e+09,7.43001e+06
20050923,613800,359500,254300,-16671,1.01332e+10,4.8307e+09,5.33038e+06
20050926,615100,309700,305400,29453,1.01372e+10,4.84813e+09,2.62172e+06
20050927,616000,278000,338000,10147,1.01382e+10,4.86471e+09,603827
20050928,615800,300000,315800,74636,1.01503e+10,4.86734e+09,2.1425e+06
20050929,615300,310900,304400,62735,1.01628e+10,4.91273e+09,2.77642e+06
20050930,613600,330200,283400,-18804,1.01626e+10,4.91258e+09,3.67866e+06
20051003,612600,372700,239900,73396,1.01726e+10,4.91682e+09,6.40798e+06
20051004,611300,398000,213300,-103333,1.01537e+10,4.85107e+09,8.23903e+06
20051005,611800,390700,221100,-161485,1.0125e+10,4.76021e+09,7.22579e+06
20051006,612500,377600,234900,-28776,1.01195e+10,4.73502e+09,5.6375e+06
20051007,614400,355000,259400,30414,1.01253e+10,4.77823e+09,4.17344e+06
20051010,614900,288100,326800,70832,1.0137e+10,4.73776e+09,-398335
20051011,616900,249700,367200,-6562,1.01382e+10,4.74605e+09,-3.47954e+06
20051012,619100,232700,386400,56534,1.01487e+10,4.73382e+09,-4.84977e+06
20051013,619600,224100,395500,58387,1.0157e+10,4.72516e+09,-5.96159e+06
20051014,620100,214100,406000,-66821,1.01417e+10,4.78122e+09,-6.72864e+06
20051017,619900,223800,396100,-63674,1.01259e+10,4.80321e+09,-5.83149e+06
20051018,620500,225500,395000,141524,1.01504e+10,4.7583e+09,-5.34016e+06
20051019,620600,238300,382300,-26614,1.0138e+10,4.82634e+09,-4.1709e+06
20051020,620500,257200,363300,92063,1.01569e+10,4.76524e+09,-2.40455e+06
20051021,619800,271700,348100,-19851,1.01575e+10,4.7845e+09,-1.10508e+06
20051024,617200,293100,324100,-23505,1.01522e+10,4.84327e+09,765445
20051025,616400,318600,297800,-66229,1.01436e+10,4.82432e+09,2.84609e+06
20051026,617100,321000,296100,46093,1.01561e+10,4.81612e+09,3.09134e+06
20051027,618000,343300,274700,3245,1.01548e+10,4.7645e+09,4.31866e+06
20051028,618000,368300,249700,87841,1.01706e+10,4.85955e+09,6.16202e+06
20051031,618100,393700,224400,96359,1.0189e+10,4.91738e+09,8.42417e+06
20051101,618300,425100,193200,28296,1.01936e+10,4.91173e+09,9.9398e+06
20051102,616300,444200,172100,170686,1.02266e+10,4.96646e+09,1.15915e+07
20051103,615600,477200,138400,4941,1.02302e+10,4.97538e+09,1.39518e+07
20051104,613800,502100,111700,-21846,1.02267e+10,4.95276e+09,1.56575e+07
20051107,613800,519600,94200,50084,1.02366e+10,4.96892e+09,1.68846e+07
20051108,614000,536100,77900,-77764,1.02243e+10,4.9477e+09,1.748e+07
20051109,614600,532100,82500,74605,1.02373e+10,4.96584e+09,1.74378e+07
20051110,615400,537700,77700,204750,1.02757e+10,5.01665e+09,1.76209e+07
20051111,615500,534300,81200,44362,1.02841e+10,5.02953e+09,1.74103e+07
20051114,615800,534100,81700,-50217,1.02736e+10,5.02564e+09,1.72544e+07
20051115,615800,532100,83700,-103114,1.02577e+10,4.99994e+09,1.7274e+07
20051116,616600,534500,82100,-7751,1.0257e+10,5.01535e+09,1.72717e+07
20051117,616500,540600,75900,271671,1.03055e+10,5.08403e+09,1.81671e+07
20051118,617700,540700,77000,76875,1.03203e+10,5.10289e+09,1.85075e+07
20051121,614900,539800,75100,125539,1.03448e+10,5.12356e+09,1.87894e+07
20051122,613100,554300,58800,142070,1.03707e+10,5.13436e+09,1.98836e+07
20051123,613300,567200,46100,29739,1.03737e+10,5.14495e+09,2.0586e+07
20051125,613900,567900,46000,64326,1.03883e+10,5.1678e+09,2.07801e+07
20051128,613800,568600,45200,-227388,1.03454e+10,5.10471e+09,2.06733e+07
20051129,613800,567600,46200,53654,1.03547e+10,5.12019e+09,2.04834e+07
20051130,613800,561500,52300,-93257,1.0336e+10,5.09871e+09,1.99101e+07
20051201,613100,551200,61900,261736,1.03845e+10,5.16783e+09,1.92902e+07
20051202,612700,554400,58300,13753,1.03878e+10,5.17037e+09,1.94305e+07
20051205,611800,542600,69200,-82036,1.03727e+10,5.13916e+09,1.86962e+07
20051206,610300,533200,77100,37792,1.03791e+10,5.1427e+09,1.81028e+07
20051207,610300,534700,75600,-121750,1.03588e+10,5.11047e+09,1.80967e+07
20051208,610400,527500,82900,5454,1.03591e+10,5.12048e+09,1.73884e+07
20051209,609700,520100,89600,64833,1.03701e+10,5.13122e+09,1.69659e+07
20051212,608300,514100,94200,37203,1.03782e+10,5.12975e+09,1.67268e+07
20051213,606700,499200,107500,76251,1.0387e+10,5.142e+09,1.55534e+07
20051214,607600,504900,102700,74979,1.03987e+10,5.18748e+09,1.59353e+07
20051215,607100,507600,99500,-74433,1.03851e+10,5.15777e+09,1.58446e+07
20051216,608500,506700,101800,-72641,1.03779e+10,5.12302e+09,1.5545e+07
20051219,608100,508500,99600,-157126,1.03505e+10,5.06995e+09,1.53844e+07
20051220,608000,494700,113300,26713,1.03548e+10,5.08455e+09,1.46566e+07
20051221,607800,485600,122200,44343,1.03591e+10,5.10947e+09,1.40822e+07
20051222,608500,467100,141400,73580,1.03715e+10,5.13706e+09,1.31039e+07
20051223,608000,456900,151100,25535,1.03759e+10,5.1421e+09,1.28746e+07
20051227,607400,439800,167600,-86837,1.03597e+10,5.09421e+09,1.2353e+07
20051228,606900,440600,166300,37314,1.03644e+10,5.10538e+09,1.22537e+07
20051229,606400,436200,170200,-45453,1.03508e+10,5.08807e+09,1.19528e+07
20051230,607700,420500,187200,-55304,1.03395e+10,5.06741e+09,1.06994e+07
20060103,609000,421800,187200,109269,1.03611e+10,5.16698e+09,1.07556e+07
20060104,607200,434500,172700,73091,1.0376e+10,5.1844e+09,1.14712e+07
20060105,605600,468500,137100,11612,1.03744e+10,5.16601e+09,1.35555e+07
20060106,604100,509700,94400,190274,1.04113e+10,5.21108e+09,1.65037e+07
20060109,598500,527200,71300,123207,1.04366e+10,5.1934e+09,1.80059e+07
20060110,595900,536700,59200,-14221,1.043e+10,5.16889e+09,1.88812e+07
20060111,595200,542000,53200,38367,1.04379e+10,5.17374e+09,1.92721e+07
20060112,594600,546900,47700,-116123,1.04189e+10,5.13953e+09,1.95109e+07
20060113,593100,549700,43400,31122,1.0424e+10,5.13548e+09,1.97088e+07
20060117,592600,551700,40900,-66520,1.04146e+10,5.11521e+09,1.92362e+07
20060118,593300,543000,50300,-20752,1.04095e+10,5.1074e+09,1.83758e+07
20060119,592800,529000,63800,177454,1.04418e+10,5.14317e+09,1.76959e+07
20060120,593500,501000,92500,-233493,1.04003e+10,5.08222e+09,1.58921e+07
20060123,593700,476700,117000,27616,1.04048e+10,5.09574e+09,1.3946e+07
20060124,593000,456000,137000,118449,1.04284e+10,5.13961e+09,1.29724e+07
20060125,593500,436700,156800,-56724,1.04181e+10,5.12545e+09,1.12414e+07
20060126,595200,410800,184400,98785,1.04366e+10,5.19022e+09,9.23092e+06
20060127,594700,415200,179500,125992,1.04611e+10,5.23047e+09,9.36108e+06
20060130,593200,426500,166700,38122,1.04648e+10,5.23063e+09,1.05765e+07
20060131,592300,429600,162700,13348,1.04726e+10,5.21898e+09,1.04682e+07
20060201,591500,422300,169200,-1243,1.04738e+10,5.21288e+09,1.01989e+07
20060202,590400,415800,174600,-75561,1.04598e+10,5.17067e+09,1.00859e+07
20060203,591200,398500,192700,-26920,1.04585e+10,5.15958e+09,9.34716e+06
20060206,592100,387800,204300,72042,1.04702e+10,5.18308e+09,8.36184e+06
20060207,593200,368800,224400,-91164,1.04597e+10,5.12666e+09,6.80482e+06
20060208,594100,348500,245600,30935,1.04621e+10,5.15849e+09,5.05801e+06
20060209,594100,348400,245700,43397,1.04756e+10,5.14363e+09,4.37034e+06
20060210,591700,350900,240800,30716,1.04793e+10,5.13607e+09,4.46355e+06
20060213,590500,350800,239700,907,1.04814e+10,5.10571e+09,4.40028e+06
20060214,590300,380600,209700,98985,1.04978e+10,5.15112e+09,6.76169e+06
20060215,590100,406200,183900,63021,1.05101e+10,5.17124e+09,8.37673e+06
20060216,587600,427700,159900,47270,1.05175e+10,5.18799e+09,1.00376e+07
20060217,586800,441400,145400,-29473,1.05136e+10,5.17445e+09,1.1508e+07
20060221,585500,452200,133300,-108620,1.04897e+10,5.15303e+09,1.23019e+07
20060222,585000,469900,115100,214376,1.05296e+10,5.18969e+09,1.38121e+07
20060223,585200,474400,110800,-33566,1.05239e+10,5.18196e+09,1.4797e+07
20060224,585200,468700,116500,18037,1.05275e+10,5.1949e+09,1.46247e+07
20060227,583600,474600,109000,69764,1.0537e+10,5.19641e+09,1.53497e+07
20060228,583300,476600,106700,-174818,1.05035e+10,5.16616e+09,1.56791e+07
20060301,582500,477500,105000,108415,1.0526e+10,5.20756e+09,1.59993e+07
20060302,581700,483300,98400,-46052,1.05165e+10,5.19564e+09,1.64693e+07
20060303,581000,480600,100400,-19580,1.05119e+10,5.18477e+09,1.61862e+07
20060306,581800,465800,116000,-71192,1.04925e+10,5.14988e+09,1.52873e+07
20060307,581100,445000,136100,-40751,1.04832e+10,5.11253e+09,1.42578e+07
20060308,581800,423700,158100,29233,1.04893e+10,5.12164e+09,1.26285e+07
20060309,582300,410700,171600,-15677,1.04887e+10,5.11236e+09,1.13086e+07
20060310,583200,387900,195300,109478,1.05092e+10,5.16288e+09,9.40838e+06
20060313,582600,371900,210700,1603,1.05092e+10,5.17625e+09,8.30772e+06
20060314,581600,375400,206200,44373,1.05168e+10,5.23253e+09,8.55138e+06
20060315,581200,384300,196900,84673,1.05338e+10,5.26815e+09,9.45778e+06
20060316,579500,418700,160800,58513,1.05447e+10,5.2726e+09,1.22494e+07
20060317,578200,441200,137000,59829,1.05546e+10,5.28074e+09,1.47652e+07
20060320,576500,454800,121700,-54584,1.05436e+10,5.2455e+09,1.58238e+07
20060321,575900,464200,111700,-114847,1.05191e+10,5.20236e+09,1.60467e+07
20060322,573700,474900,98800,109552,1.05394e+10,5.20102e+09,1.65582e+07
20060323,574200,472400,101800,-8817,1.05369e+10,5.20212e+09,1.63286e+07
20060324,574100,473800,100300,19119,1.05401e+10,5.21441e+09,1.65777e+07
20060327,574300,480600,93700,-24593,1.05348e+10,5.20305e+09,1.67886e+07
20060328,573800,484400,89400,-65466,1.05227e+10,5.17472e+09,1.68461e+07
20060329,573400,486600,86800,153249,1.05539e+10,5.22348e+09,1.68384e+07
20060330,573300,482500,90800,-37941,1.05461e+10,5.20903e+09,1.64088e+07
20060331,574600,468700,105900,-13180,1.05428e+10,5.21123e+09,1.53312e+07
20060403,574800,466500,108300,-6032,1.0541e+10,5.21802e+09,1.48521e+07
20060404,574800,464600,110200,87674,1.05555e+10,5.24762e+09,1.45803e+07
20060405,574700,455500,119200,100204,1.05736e+10,5.27567e+09,1.40356e+07
20060406,575300,439900,135400,-1330,1.05755e+10,5.26965e+09,1.30877e+07
20060407,575300,432300,143000,-122533,1.05568e+10,5.20013e+09,1.2448e+07
20060410,576300,419500,156800,-34446,1.05569e+10,5.17894e+09,1.13678e+07
20060411,576800,394200,182600,-64777,1.05491e+10,5.13412e+09,9.25254e+06
20060412,578100,351300,226800,-10220,1.05452e+10,5.16252e+09,6.6117e+06
20060413,578500,324500,254000,24399,1.05484e+10,5.17326e+09,4.61356e+06
20060417,578500,310800,267700,41095,1.05542e+10,5.17694e+09,3.57803e+06
20060418,577800,312800,265000,96227,1.057e+10,5.27497e+09,3.62582e+06
20060419,577000,337000,240000,56687,1.05809e+10,5.29668e+09,5.24626e+06
20060420,576500,365200,211300,-25839,1.05757e+10,5.29367e+09,8.02579e+06
20060421,575100,392200,182900,29248,1.05851e+10,5.27351e+09,1.04601e+07
20060424,574500,415900,158600,-30862,1.05772e+10,5.27136e+09,1.23344e+07
20060425,575600,415800,159800,-71767,1.05643e+10,5.24439e+09,1.27622e+07
20060426,575200,421800,153400,41341,1.05737e+10,5.24197e+09,1.2909e+07
20060427,574600,417100,157500,46879,1.05851e+10,5.23514e+09,1.25413e+07
20060428,574600,427300,147300,5372,1.05855e+10,5.24022e+09,1.27821e+07
20060501,575000,428300,146700,-42684,1.05778e+10,5.22627e+09,1.20596e+07
20060502,573500,434800,138700,111079,1.05957e+10,5.23586e+09,1.27236e+07
20060503,573300,440500,132800,15339,1.05983e+10,5.22755e+09,1.28059e+07
20060504,571800,447100,124700,107663,1.06176e+10,5.25054e+09,1.32205e+07
20060505,571100,450200,120900,123579,1.06403e+10,5.3081e+09,1.36809e+07
20060508,570400,455400,115000,-1337,1.06415e+10,5.30317e+09,1.40464e+07
20060509,570100,447700,122400,2141,1.0642e+10,5.28447e+09,1.406e+07
20060510,569400,456300,113100,1971,1.06394e+10,5.29447e+09,1.47162e+07
20060511,570000,446100,123900,-199975,1.06072e+10,5.22566e+09,1.40314e+07
20060512,571100,432400,138700,-230313,1.05637e+10,5.15359e+09,1.23683e+07
20060515,574300,382900,191400,54013,1.05727e+10,5.18362e+09,9.23116e+06
20060516,575800,351100,224700,11938,1.05775e+10,5.18116e+09,6.02212e+06
20060517,579700,278100,301600,16136,1.05762e+10,5.10743e+09,375017
20060518,581500,225100,356400,76927,1.05892e+10,5.0816e+09,-3.84273e+06
20060519,582400,204200,378200,-93965,1.05771e+10,5.08417e+09,-5.51042e+06
20060522,584200,192300,391900,127885,1.06021e+10,5.0592e+09,-6.79775e+06
20060523,584800,166200,418600,49475,1.06111e+10,5.04344e+09,-9.24534e+06
20060524,584800,164900,419900,45414,1.06205e+10,5.02632e+09,-9.57892e+06
20060525,584700,172700,412000,-162354,1.05876e+10,5.09422e+09,-9.48745e+06
20060526,584200,178300,405900,-54697,1.05775e+10,5.11452e+09,-8.93539e+06
20060530,584600,187900,396700,196181,1.06188e+10,5.0403e+09,-8.10775e+06
20060531,584600,220700,363900,-82141,1.0605e+10,5.09995e+09,-6.00761e+06
20060601,584500,252700,331800,-184814,1.057e+10,5.12962e+09,-3.70174e+06
20060602,582500,289500,293000,17156,1.0572e+10,5.12712e+09,-395165
20060605,582500,323700,258800,45727,1.05827e+10,5.01829e+09,1.83546e+06
20060606,582600,340200,242400,38906,1.05887e+10,4.99227e+09,3.43421e+06
20060607,581900,350500,231400,55254,1.06042e+10,4.95807e+09,4.3382e+06
20060608,583200,331900,251300,17567,1.06079e+10,4.96838e+09,3.51749e+06
20060609,583900,313200,270700,21693,1.0612e+10,4.96339e+09,2.12419e+06
20060612,584800,299000,285800,94617,1.06318e+10,4.86304e+09,1.03442e+06
20060613,587900,270100,317800,86128,1.06453e+10,4.82571e+09,-994986
20060614,589100,255600,333500,-135385,1.06185e+10,4.85964e+09,-2.29902e+06
20060615,589200,251200,338000,-196616,1.05793e+10,4.97488e+09,-2.86753e+06
20060616,591100,242700,348400,33606,1.05853e+10,4.96903e+09,-3.2993e+06
20060619,591300,267100,324200,84403,1.05993e+10,4.91441e+09,-1.40731e+06
20060620,591500,299700,291800,26341,1.06045e+10,4.9105e+09,1.12244e+06
20060621,590900,322900,268000,-12129,1.06091e+10,4.97947e+09,2.89413e+06
20060622,592400,312000,280400,-6274,1.0608e+10,4.9859e+09,1.98814e+06
20060623,593000,302000,291000,-22834,1.06073e+10,5.00493e+09,1.35629e+06
20060626,592500,332700,259800,9941,1.06054e+10,5.00072e+09,4.7341e+06
20060627,593500,348100,245400,-19534,1.06013e+10,4.9662e+09,6.07752e+06
20060628,594600,351200,243400,24334,1.06029e+10,5.00039e+09,6.3442e+06
20060629,594400,387300,207100,234317,1.06482e+10,5.12428e+09,9.51458e+06
20060630,595600,436300,159300,72352,1.06618e+10,5.14878e+09,1.27348e+07
20060703,595000,461000,134000,81293,1.06784e+10,5.16837e+09,1.46529e+07
20060705,595000,494700,100300,-140835,1.06502e+10,5.12524e+09,1.6319e+07
20060706,594500,516600,77900,32426,1.06581e+10,5.12438e+09,1.75925e+07
20060707,596400,510100,86300,-183363,1.06234e+10,5.08066e+09,1.70752e+07
20060710,598000,496300,101700,-44622,1.06139e+10,5.032e+09,1.6224e+07
20060711,598500,483100,115400,89966,1.06302e+10,5.06381e+09,1.57038e+07
20060712,601200,453900,147300,-84864,1.06162e+10,5.04398e+09,1.39833e+07
20060713,606100,410700,195400,-155573,1.05891e+10,5.02242e+09,1.0793e+07
20060714,608000,381400,226600,-31164,1.05849e+10,4.99992e+09,8.64266e+06
20060717,614600,335700,278900,-29643,1.05797e+10,5.02286e+09,4.75334e+06
20060718,618600,289000,329600,92429,1.05994e+10,5.05527e+09,921524
20060719,620000,270400,349600,-71911,1.05857e+10,5.182e+09,-205848
20060720,620300,273900,346400,164980,1.06191e+10,5.10829e+09,-138793
20060721,621900,264300,357600,144790,1.06441e+10,5.07011e+09,-935140
20060724,621100,279000,342100,-78717,1.06316e+10,5.16466e+09,-21263
20060725,619500,292400,327100,4135,1.06334e+10,5.1803e+09,1.17934e+06
20060726,619700,301300,318400,82263,1.06523e+10,5.16381e+09,1.88094e+06
20060727,618200,339800,278400,-22126,1.06418e+10,5.11917e+09,3.54587e+06
20060728,615400,402700,212700,61879,1.06515e+10,5.17898e+09,7.33529e+06
20060731,614200,427300,186900,-60578,1.06461e+10,5.14177e+09,9.24151e+06
20060801,615100,431900,183200,-22387,1.06446e+10,5.11359e+09,9.24851e+06
20060802,614600,440100,174500,66682,1.06579e+10,5.14536e+09,9.91088e+06
20060803,613600,457500,156100,24393,1.06606e+10,5.15527e+09,1.1193e+07
20060804,612900,462600,150300,21850,1.06621e+10,5.14953e+09,1.16606e+07
20060807,612900,473500,139400,-16152,1.06585e+10,5.12437e+09,1.23755e+07
20060808,613200,486200,127000,-24748,1.06532e+10,5.10136e+09,1.34007e+07
20060809,613900,487000,126900,-64007,1.06443e+10,5.07261e+09,1.34346e+07
20060810,613900,479600,134300,78710,1.06577e+10,5.10477e+09,1.28925e+07
20060811,614500,466900,147600,-93839,1.06387e+10,5.06355e+09,1.19443e+07
20060814,616100,448900,167200,-26097,1.06389e+10,5.06661e+09,1.02905e+07
20060815,619200,459100,160100,158531,1.06699e+10,5.16982e+09,1.07272e+07
20060816,619600,469100,150500,94888,1.06915e+10,5.18967e+09,1.12995e+07
20060817,619400,486000,133400,22932,1.06914e+10,5.18588e+09,1.28683e+07
20060818,618700,520900,97800,-2708,1.06909e+10,5.18876e+09,1.52722e+07
20060821,618600,539300,79300,-114061,1.06703e+10,5.16699e+09,1.66234e+07
20060822,619100,550700,68400,18091,1.06717e+10,5.17948e+09,1.73755e+07
20060823,618900,551900,67000,-98028,1.06558e+10,5.14352e+09,1.73129e+07
20060824,619200,554300,64900,-14861,1.06558e+10,5.14148e+09,1.73377e+07
20060825,619700,541300,78400,-16762,1.06512e+10,5.13696e+09,1.61322e+07
20060828,620000,544600,75400,150740,1.06797e+10,5.17063e+09,1.65197e+07
20060829,620200,546700,73500,86776,1.06931e+10,5.18806e+09,1.67425e+07
20060830,620000,553500,66500,51224,1.07024e+10,5.18503e+09,1.71572e+07
20060831,619400,549000,70400,48409,1.07139e+10,5.18882e+09,1.6947e+07
20060901,617900,553000,64900,58622,1.07236e+10,5.19763e+09,1.72913e+07
20060905,617200,562400,54800,23285,1.07314e+10,5.19492e+09,1.81327e+07
20060906,618000,563100,54900,-165457,1.06992e+10,5.14038e+09,1.7953e+07
20060907,618400,565800,52600,-96995,1.06775e+10,5.11611e+09,1.81012e+07
20060908,618700,546000,72700,152010,1.07067e+10,5.14563e+09,1.69377e+07
20060911,620500,513600,106900,97478,1.07254e+10,5.16202e+09,1.48974e+07
20060912,620200,510800,109400,213716,1.07691e+10,5.22247e+09,1.4882e+07
20060913,617700,493600,124100,33961,1.07776e+10,5.22793e+09,1.41631e+07
20060914,616500,499200,117300,31199,1.07805e+10,5.20733e+09,1.45209e+07
20060915,615400,517500,97900,87572,1.07963e+10,5.21335e+09,1.56862e+07
20060918,613400,514000,99400,-85867,1.07806e+10,5.19321e+09,1.54112e+07
20060919,613200,518900,94300,16905,1.0782e+10,5.18365e+09,1.56578e+07
20060920,610700,505000,105700,179638,1.08156e+10,5.18304e+09,1.54467e+07
20060921,610200,502100,108100,-143331,1.07875e+10,5.15277e+09,1.50381e+07
20060922,610800,494000,116800,-25340,1.07843e+10,5.13951e+09,1.48057e+07
20060925,610700,493100,117600,184702,1.08196e+10,5.1846e+09,1.48648e+07
20060926,610400,494400,116000,69376,1.08314e+10,5.22208e+09,1.51609e+07
20060927,609000,495400,113600,-28739,1.08276e+10,5.23289e+09,1.52323e+07
20060928,607900,503100,104800,33387,1.08364e+10,5.22811e+09,1.62277e+07
20060929,606800,526400,80400,-102054,1.08201e+10,5.19415e+09,1.75745e+07
20061002,606400,531000,75400,-63632,1.08057e+10,5.17208e+09,1.8146e+07
20061003,606200,523000,83200,116273,1.08273e+10,5.16833e+09,1.77549e+07
20061004,605400,522700,82700,246343,1.08751e+10,5.23083e+09,1.79636e+07
20061005,604700,530900,73800,72672,1.08902e+10,5.25679e+09,1.81462e+07
20061006,604000,525100,78900,-48540,1.08785e+10,5.23467e+09,1.79333e+07
20061009,602700,527100,75600,69188,1.08928e+10,5.24004e+09,1.8092e+07
20061010,602600,535500,67100,47932,1.09009e+10,5.25332e+09,1.87361e+07
20061011,601800,541400,60400,-70274,1.08845e+10,5.23733e+09,1.92315e+07
20061012,601500,546100,55400,220732,1.09245e+10,5.28507e+09,1.99319e+07
20061013,600600,541800,58800,50347,1.09316e+10,5.29178e+09,1.94604e+07
20061016,598800,543500,55300,104760,1.09482e+10,5.31347e+09,1.96157e+07
20061017,598800,541000,57800,-104270,1.0932e+10,5.28291e+09,1.94797e+07
20061018,599100,548500,50600,10201,1.09332e+10,5.29522e+09,2.01036e+07
20061019,598600,539200,59400,43060,1.09458e+10,5.28813e+09,1.96151e+07
20061020,598500,518500,80000,-41230,1.0939e+10,5.27283e+09,1.882e+07
20061023,597200,506400,90800,141395,1.09621e+10,5.29272e+09,1.83203e+07
20061024,597000,511000,86000,47304,1.09676e+10,5.30021e+09,1.8619e+07
20061025,594800,504600,90200,54847,1.0979e+10,5.28206e+09,1.82485e+07
20061026,594200,511000,83200,127383,1.10031e+10,5.31125e+09,1.84765e+07
20061027,595800,515500,80300,-177675,1.09749e+10,5.2652e+09,1.8597e+07
20061030,594600,512500,82100,45032,1.09844e+10,5.26991e+09,1.80324e+07
20061031,593800,506300,87500,-2243,1.09835e+10,5.26595e+09,1.73934e+07
20061101,593000,495800,97200,-139225,1.09572e+10,5.21676e+09,1.64947e+07
20061102,591600,477500,114100,-6793,1.09555e+10,5.20329e+09,1.48618e+07
20061103,592500,453400,139100,9379,1.09556e+10,5.20477e+09,1.3319e+07
20061106,591400,437800,153600,164782,1.09841e+10,5.259e+09,1.2264e+07
20061107,590600,433400,157200,13580,1.09832e+10,5.26857e+09,1.17463e+07
20061108,588800,434700,154100,82344,1.09977e+10,5.27003e+09,1.23962e+07
20061109,586500,428000,158500,20533,1.09982e+10,5.21418e+09,1.17439e+07
20061110,584000,443100,140900,17334,1.10018e+10,5.21542e+09,1.30331e+07
20061113,583700,450800,132900,45144,1.10085e+10,5.23481e+09,1.3436e+07
20061114,582100,462000,120100,51451,1.10179e+10,5.26218e+09,1.41444e+07
20061115,581100,481900,99200,69150,1.1031e+10,5.28129e+09,1.52487e+07
20061116,579400,501400,78000,43929,1.10394e+10,5.27835e+09,1.65867e+07
20061117,577300,512300,65000,7491,1.1045e+10,5.25001e+09,1.7542e+07
20061120,576200,518000,58200,549,1.1047e+10,5.24721e+09,1.8249e+07
20061121,574600,520100,54500,79737,1.1064e+10,5.26206e+09,1.87297e+07
20061122,573600,520800,52800,74311,1.10759e+10,5.27254e+09,1.88867e+07
20061124,573100,520100,53000,-44427,1.10665e+10,5.25853e+09,1.91959e+07
20061127,573300,517500,55800,-327954,1.10049e+10,5.17458e+09,1.86308e+07
20061128,572700,500300,72400,25118,1.10055e+10,5.18632e+09,1.8151e+07
20061129,571500,486700,84800,184727,1.10396e+10,5.22983e+09,1.73432e+07
20061130,571900,477700,94200,67706,1.10517e+10,5.24877e+09,1.70646e+07
20061201,570500,445800,124700,-48409,1.10423e+10,5.21292e+09,1.47693e+07
20061204,569700,443600,126100,135071,1.10673e+10,5.27218e+09,1.48852e+07
20061205,568900,453200,115700,88874,1.1083e+10,5.29298e+09,1.56877e+07
20061206,567700,456100,111600,-11401,1.10828e+10,5.27742e+09,1.60151e+07
20061207,567600,463500,104100,-64637,1.10707e+10,5.25155e+09,1.65341e+07
20061208,566800,474600,92200,10458,1.10743e+10,5.24248e+09,1.74803e+07
20061211,566800,480400,86400,18934,1.10776e+10,5.24258e+09,1.79631e+07
20061212,566200,471900,94300,-47699,1.1068e+10,5.21386e+09,1.72988e+07
20061213,565800,457200,108600,-6127,1.10661e+10,5.20495e+09,1.63412e+07
20061214,564900,460600,104300,118724,1.10876e+10,5.23732e+09,1.65636e+07
20061215,564400,465400,99000,-22131,1.10851e+10,5.22318e+09,1.66516e+07
20061218,563900,465400,98500,-82230,1.10698e+10,5.1893e+09,1.5935e+07
20061219,562800,455700,107100,71907,1.10809e+10,5.19298e+09,1.52451e+07
20061220,562000,454500,107500,15975,1.10873e+10,5.18297e+09,1.51114e+07
20061221,562000,429100,132900,-24423,1.10841e+10,5.15436e+09,1.25611e+07
20061222,562800,410300,152500,-4484,1.10816e+10,5.14007e+09,1.06479e+07
20061226,563400,391600,171800,62900,1.10937e+10,5.16987e+09,9.2907e+06
20061227,562800,390900,171900,44515,1.11027e+10,5.20274e+09,8.92746e+06
20061228,562800,387100,175700,-22844,1.10988e+10,5.19434e+09,8.78925e+06
20061229,563500,394300,169200,-46079,1.10897e+10,5.1774e+09,8.97319e+06
20070103,563000,400100,162900,73000,1.10985e+10,5.17055e+09,9.73051e+06
20070104,562200,411600,150600,-3962,1.10964e+10,5.16678e+09,1.06952e+07
20070105,562300,412200,150100,-105475,1.10769e+10,5.13029e+09,1.0557e+07
20070108,561500,410600,150900,52796,1.10875e+10,5.13766e+09,1.04412e+07
20070109,562600,403900,158700,69316,1.11007e+10,5.16813e+09,9.78501e+06
20070110,561200,399700,161500,100275,1.11192e+10,5.17637e+09,9.43178e+06
20070111,560700,399300,161400,114280,1.11397e+10,5.21672e+09,9.622e+06
20070112,559900,408400,151500,2942,1.11428e+10,5.23396e+09,1.06022e+07
20070116,559200,415100,144100,65714,1.11533e+10,5.23857e+09,1.15562e+07
20070117,557000,431700,125300,-31695,1.11488e+10,5.22916e+09,1.29383e+07
20070118,555900,445300,110600,-83776,1.11338e+10,5.19313e+09,1.41319e+07
20070119,555600,446300,109300,35353,1.11407e+10,5.21606e+09,1.44977e+07
20070122,556000,437900,118100,-83014,1.11251e+10,5.19126e+09,1.42756e+07
20070123,556500,438500,118000,110529,1.11469e+10,5.23923e+09,1.49597e+07
20070124,554900,431400,123500,106057,1.11665e+10,5.27166e+09,1.4897e+07
20070125,555000,437600,117400,-173168,1.11383e+10,5.21131e+09,1.50803e+07
20070126,554300,420700,133600,-7041,1.1137e+10,5.20077e+09,1.39864e+07
20070129,554100,420100,134000,21943,1.11419e+10,5.20481e+09,1.39907e+07
20070130,554100,420100,134000,84827,1.11572e+10,5.2314e+09,1.40095e+07
20070131,552700,416900,135800,147438,1.11846e+10,5.26278e+09,1.37548e+07
20070201,553300,440600,112700,138908,1.12097e+10,5.31339e+09,1.54952e+07
20070202,551300,457100,94200,54089,1.12205e+10,5.3159e+09,1.69231e+07
20070205,550000,453800,96200,-893,1.12202e+10,5.29254e+09,1.67725e+07
20070206,548900,459800,89100,51808,1.12272e+10,5.30865e+09,1.73234e+07
20070207,548000,458100,89900,60031,1.12374e+10,5.32379e+09,1.74709e+07
20070208,547000,464300,82700,9918,1.12407e+10,5.30945e+09,1.76752e+07
20070209,546300,458100,88200,-121938,1.12195e+10,5.26412e+09,1.73109e+07
20070212,546300,455400,90900,-64472,1.12062e+10,5.24531e+09,1.6777e+07
20070213,546100,452300,93800,129796,1.12295e+10,5.29193e+09,1.63128e+07
20070214,545200,448600,96600,126131,1.12542e+10,5.32593e+09,1.61878e+07
20070215,544700,450600,94100,51794,1.12632e+10,5.33873e+09,1.64754e+07
20070216,544600,461000,83600,21686,1.12662e+10,5.34405e+09,1.74754e+07
20070220,543600,464900,78700,110904,1.12882e+10,5.36552e+09,1.76482e+07
20070221,543300,471600,71700,346,1.12877e+10,5.36629e+09,1.78734e+07
20070222,541600,472100,69500,12099,1.12932e+10,5.33876e+09,1.80577e+07
20070223,541500,474300,67200,-16717,1.12908e+10,5.32454e+09,1.80257e+07
20070226,541400,470100,71300,-25722,1.12847e+10,5.30569e+09,1.77509e+07
20070227,542000,439100,102900,-550468,1.11868e+10,5.12805e+09,1.5147e+07
20070228,543900,385900,158000,54892,1.11966e+10,5.17521e+09,1.04845e+07
20070301,545800,332000,213800,27733,1.12029e+10,5.17936e+09,5.66257e+06
20070302,548800,234000,314800,64906,1.12142e+10,5.13592e+09,-2.26032e+06
20070305,552200,133000,419200,166138,1.12491e+10,5.09578e+09,-9.97828e+06
20070306,552500,121400,431100,-183690,1.12103e+10,5.18503e+09,-1.1112e+07
20070307,552600,111100,441500,58229,1.12177e+10,5.1724e+09,-1.2132e+07
20070308,552400,101700,450700,-123891,1.11956e+10,5.2214e+09,-1.28553e+07
20070309,551800,109400,442400,-15067,1.11931e+10,5.22592e+09,-1.2003e+07
20070312,551300,131600,419700,-19123,1.1191e+10,5.24022e+09,-9.96218e+06
20070313,551200,143600,407600,237953,1.12367e+10,5.1282e+09,-9.1027e+06
20070314,550800,149200,401600,-37582,1.12274e+10,5.15343e+09,-8.41793e+06
20070315,550500,157100,393400,-40896,1.12191e+10,5.1777e+09,-7.60082e+06
20070316,550100,170400,379700,58638,1.12317e+10,5.14147e+09,-6.69828e+06
20070319,549700,189600,360100,1942,1.12254e+10,5.17779e+09,-5.34717e+06
20070320,548500,241800,306700,-3024,1.1227e+10,5.20448e+09,-766723
20070321,546200,358500,187700,127334,1.12499e+10,5.2591e+09,8.85748e+06
20070322,543400,426900,116500,10933,1.1252e+10,5.22831e+09,1.42445e+07
20070323,541000,464800,76200,56719,1.12601e+10,5.2273e+09,1.76762e+07
20070326,539100,497900,41200,6948,1.12638e+10,5.193e+09,1.98391e+07
20070327,539800,503400,36400,-159808,1.12289e+10,5.15983e+09,1.99179e+07
20070328,540500,504500,36000,-139866,1.12031e+10,5.12659e+09,1.97958e+07
20070329,538200,500500,37700,40240,1.1211e+10,5.10219e+09,1.952e+07
20070330,539300,487700,51600,-1595,1.12098e+10,5.11265e+09,1.83652e+07
20070402,540300,468200,72100,29549,1.12043e+10,5.14305e+09,1.7092e+07
20070403,541700,461900,79800,111181,1.12258e+10,5.19586e+09,1.6659e+07
20070404,541700,461700,80000,21079,1.12288e+10,5.19805e+09,1.68799e+07
20070405,541600,460900,80700,45246,1.12381e+10,5.21254e+09,1.68087e+07
20070409,541100,480500,60600,20049,1.1239e+10,5.22093e+09,1.82115e+07
20070410,541000,489900,51100,31736,1.1244e+10,5.21768e+09,1.8858e+07
20070411,541200,487700,53500,-114168,1.12209e+10,5.18392e+09,1.87572e+07
20070412,541000,484100,56900,106695,1.12404e+10,5.2125e+09,1.8624e+07
20070413,541000,484200,56800,52174,1.12515e+10,5.22227e+09,1.86592e+07
20070416,540600,488000,52600,142487,1.12821e+10,5.26348e+09,1.90421e+07
20070417,540400,488300,52100,19691,1.12868e+10,5.27301e+09,1.90551e+07
20070418,539600,491400,48200,-10184,1.12855e+10,5.26576e+09,1.91217e+07
20070419,539100,499700,39400,-44853,1.12743e+10,5.24917e+09,1.97397e+07
20070420,539400,497800,41600,169910,1.1308e+10,5.30208e+09,2.03717e+07
20070423,539300,502000,37300,20092,1.13111e+10,5.31199e+09,2.07436e+07
20070424,538900,498900,40000,18866,1.13124e+10,5.31248e+09,2.03645e+07
20070425,540400,499100,41300,197990,1.13513e+10,5.36994e+09,2.05937e+07
20070426,540200,500500,39700,16543,1.13544e+10,5.36058e+09,2.05034e+07
20070427,540100,500600,39500,-25333,1.135e+10,5.35984e+09,1.99712e+07
20070430,540100,496500,43600,-224265,1.13082e+10,5.29826e+09,1.93741e+07
20070501,540700,480700,60000,86054,1.1327e+10,5.30307e+09,1.81395e+07
20070502,541000,459200,81800,127333,1.13473e+10,5.35596e+09,1.63575e+07
20070503,540300,451800,88500,85839,1.13619e+10,5.37546e+09,1.58179e+07
20070504,539900,444500,95400,36193,1.137e+10,5.37613e+09,1.54939e+07
20070507,539400,446900,92500,27388,1.13764e+10,5.3797e+09,1.57612e+07
20070508,539000,450100,88900,-6849,1.13777e+10,5.36337e+09,1.5962e+07
20070509,538900,456900,82000,94611,1.13954e+10,5.3919e+09,1.6657e+07
20070510,538600,451100,87500,-227998,1.13495e+10,5.31362e+09,1.59276e+07
20070511,538800,441500,97300,151145,1.1376e+10,5.36905e+09,1.53631e+07
20070514,538500,431100,107400,-25742,1.13721e+10,5.35037e+09,1.42566e+07
20070515,539700,422800,116900,-11702,1.13722e+10,5.35293e+09,1.3824e+07
20070516,539400,414300,125100,98828,1.13927e+10,5.3791e+09,1.31758e+07
20070517,538800,412800,126000,26700,1.13997e+10,5.36485e+09,1.35368e+07
20070518,537700,424200,113500,108274,1.14217e+10,5.38717e+09,1.43385e+07
20070521,536400,433600,102800,49521,1.14341e+10,5.39378e+09,1.49316e+07
20070522,535700,435400,100300,-24068,1.14298e+10,5.39039e+09,1.52509e+07
20070523,535000,446200,88800,-36024,1.1421e+10,5.37094e+09,1.63066e+07
20070524,535300,447100,88200,-189296,1.13847e+10,5.29824e+09,1.63469e+07
20070525,535200,434100,101100,97826,1.14024e+10,5.32893e+09,1.5349e+07
20070529,535100,409400,125700,33633,1.141e+10,5.3545e+09,1.37079e+07
20070530,535000,410200,124800,145186,1.1437e+10,5.41086e+09,1.36333e+07
20070531,537900,402600,135300,19550,1.14405e+10,5.47776e+09,1.32465e+07
20070601,536400,407600,128800,5385,1.14461e+10,5.45124e+09,1.41652e+07
20070604,535800,418800,117000,79271,1.14605e+10,5.4643e+09,1.58751e+07
20070605,534300,438900,95400,-138431,1.14322e+10,5.39591e+09,1.71203e+07
20070606,534000,443500,90500,-168360,1.14002e+10,5.33925e+09,1.71805e+07
20070607,534500,429000,105500,-294935,1.13456e+10,5.23065e+09,1.56845e+07
20070608,534700,407700,127000,168633,1.1378e+10,5.29248e+09,1.41729e+07
20070611,534900,368100,166800,-883,1.1378e+10,5.29623e+09,1.08079e+07
20070612,535700,324000,211700,-28308,1.13733e+10,5.24419e+09,6.90442e+06
20070613,537000,300300,236700,94767,1.13917e+10,5.34145e+09,5.26983e+06
20070614,536900,308400,228500,70533,1.14038e+10,5.36382e+09,5.70574e+06
20070615,536200,314500,221700,44914,1.14121e+10,5.4036e+09,5.87687e+06
20070618,534700,329200,205500,26515,1.14168e+10,5.37872e+09,7.19003e+06
20070619,531100,351700,179400,-39053,1.14113e+10,5.33184e+09,9.19248e+06
20070620,530200,376000,154200,-82701,1.13953e+10,5.25781e+09,1.04648e+07
20070621,530100,374000,156100,121399,1.1419e+10,5.2835e+09,1.03645e+07
20070622,530300,360600,169700,-76261,1.14015e+10,5.22547e+09,9.31504e+06
20070625,529500,333100,196400,-33929,1.13974e+10,5.16974e+09,6.84481e+06
20070626,531300,305100,226200,-62160,1.13867e+10,5.1365e+09,3.8261e+06
20070627,530700,289900,240800,49315,1.13896e+10,5.17212e+09,2.78099e+06
20070628,530900,285300,245600,25292,1.1394e+10,5.17263e+09,2.11498e+06
20070629,530400,286000,244400,2957,1.13941e+10,5.15609e+09,2.47209e+06
20070702,529800,301300,228500,72396,1.14078e+10,5.21231e+09,4.19178e+06
20070703,529400,329000,200400,12886,1.14098e+10,5.21811e+09,6.48334e+06
20070705,528300,354400,173900,19460,1.14128e+10,5.22201e+09,8.68946e+06
20070706,527400,388300,139100,54631,1.14229e+10,5.23807e+09,1.191e+07
20070709,526300,425000,101300,32354,1.14294e+10,5.23253e+09,1.54726e+07
20070710,526300,429200,97100,-244397,1.13847e+10,5.14753e+09,1.54888e+07
20070711,527100,424700,102400,100654,1.14061e+10,5.17898e+09,1.53088e+07
20070712,530300,431600,98700,276070,1.14605e+10,5.32526e+09,1.60964e+07
20070713,530200,428700,101500,74619,1.1475e+10,5.34772e+09,1.62671e+07
20070716,529500,435200,94300,-49015,1.1464e+10,5.32052e+09,1.67844e+07
20070717,528600,439300,89300,15686,1.14661e+10,5.31591e+09,1.74865e+07
20070718,527600,449300,78300,-5860,1.14659e+10,5.30234e+09,1.82478e+07
20070719,526600,446600,80000,143163,1.14909e+10,5.32764e+09,1.83363e+07
20070720,528300,438000,90300,-204005,1.145e+10,5.28215e+09,1.73185e+07
20070723,530200,415200,115000,65562,1.14598e+10,5.30867e+09,1.54946e+07
20070724,533100,384200,148900,-247326,1.14105e+10,5.22661e+09,1.2533e+07
20070725,536700,342000,194700,84914,1.14299e+10,5.28512e+09,8.5378e+06
20070726,541200,263300,277900,1782,1.14286e+10,5.19503e+09,2.24332e+06
20070727,547300,192200,355100,111560,1.14487e+10,5.18555e+09,-4.24295e+06
20070730,547900,155000,392900,-128486,1.14244e+10,5.26841e+09,-7.87392e+06
20070731,548900,132700,416200,83016,1.1439e+10,5.21793e+09,-9.70399e+06
20070801,549600,107900,441700,-44248,1.14267e+10,5.25738e+09,-1.17454e+07
20070802,549700,99900,449800,-63744,1.14175e+10,5.29349e+09,-1.23262e+07
20070803,549800,100900,448900,416734,1.1495e+10,5.1491e+09,-1.19447e+07
20070806,549700,106800,442900,-226808,1.1453e+10,5.26876e+09,-1.18074e+07
20070807,548800,127000,421800,-65148,1.14401e+10,5.31058e+09,-1.00479e+07
20070808,547200,153500,393700,-121425,1.14214e+10,5.35592e+09,-7.73626e+06
20070809,546600,182700,363900,282483,1.14775e+10,5.19853e+09,-5.40542e+06
20070810,545900,226800,319100,-219924,1.14377e+10,5.19041e+09,-2.21532e+06
20070813,545800,235000,310800,-122501,1.14126e+10,5.18976e+09,-1.62679e+06
20070814,546200,232600,313600,75764,1.14253e+10,5.07851e+09,-2.27043e+06
20070815,549600,192300,357300,124788,1.14517e+10,5.01356e+09,-5.83313e+06
20070816,551400,172400,379000,7681,1.14586e+10,5.03662e+09,-7.29286e+06
20070817,552100,165900,386200,-210364,1.14164e+10,5.16531e+09,-8.41112e+06
20070820,550900,169400,381500,-48844,1.14052e+10,5.17139e+09,-8.11375e+06
20070821,551100,171600,379500,8905,1.14078e+10,5.18584e+09,-7.77387e+06
20070822,551100,238600,312500,-90882,1.13911e+10,5.26439e+09,-2.02532e+06
20070823,550900,310200,240700,-30465,1.13879e+10,5.235e+09,4.11673e+06
20070824,550700,355800,194900,98533,1.14053e+10,5.30497e+09,8.26484e+06
20070827,551300,406800,144500,-182524,1.13789e+10,5.22739e+09,1.18231e+07
20070828,552600,402800,149800,-289535,1.13283e+10,5.10248e+09,1.13834e+07
20070829,552600,409400,143200,285519,1.13748e+10,5.22918e+09,1.19614e+07
20070830,552900,411900,141000,-24625,1.13702e+10,5.21096e+09,1.17798e+07
20070831,553800,387700,166100,124466,1.13902e+10,5.29522e+09,1.04913e+07
20070904,554300,402300,152000,69765,1.14052e+10,5.33619e+09,1.16194e+07
20070905,553900,452400,101500,-158134,1.13778e+10,5.27055e+09,1.5411e+07
20070906,555400,465000,90400,93830,1.13937e+10,5.31967e+09,1.64856e+07
20070907,557400,464300,93100,-297645,1.13379e+10,5.23495e+09,1.63351e+07
20070910,559400,452300,107100,-18470,1.13349e+10,5.23339e+09,1.51761e+07
20070911,560700,440400,120300,189677,1.13728e+10,5.31151e+09,1.45778e+07
20070912,561500,423700,137800,30069,1.13778e+10,5.32462e+09,1.32758e+07
20070913,562600,404900,157700,63211,1.13902e+10,5.37621e+09,1.18275e+07
20070914,562800,404700,158100,-12096,1.1386e+10,5.37933e+09,1.18525e+07
20070917,563100,410000,153100,-47798,1.13772e+10,5.34935e+09,1.19208e+07
20070918,560400,422600,137800,364655,1.14499e+10,5.50531e+09,1.35227e+07
20070919,559700,443600,116100,130167,1.14752e+10,5.53691e+09,1.55082e+07
20070920,558800,474700,84100,-166213,1.14441e+10,5.47276e+09,1.79196e+07
20070921,558400,494000,64400,111892,1.1466e+10,5.49053e+09,1.91134e+07
20070924,558400,496900,61500,-72989,1.1452e+10,5.47609e+09,1.96391e+07
20070925,559000,484900,74100,16111,1.14618e+10,5.47646e+09,1.90532e+07
20070926,559300,479500,79800,154746,1.14908e+10,5.52028e+09,1.85912e+07
20070927,559200,477300,81900,100624,1.1512e+10,5.55192e+09,1.85402e+07
20070928,559800,461700,98100,-64085,1.14982e+10,5.53715e+09,1.73927e+07
20071001,559300,459100,100200,220301,1.15425e+10,5.59747e+09,1.74873e+07
20071002,558800,469600,89200,-40464,1.15348e+10,5.5737e+09,1.79255e+07
20071003,557800,481000,76800,-152362,1.15063e+10,5.51681e+09,1.8477e+07
20071004,557000,493100,63900,28749,1.15131e+10,5.50965e+09,1.91795e+07
20071005,555300,508800,46500,269392,1.15636e+10,5.57098e+09,2.03767e+07
20071008,554600,509700,44900,-53840,1.15544e+10,5.54999e+09,2.05333e+07
20071009,554600,504900,49700,212511,1.15964e+10,5.5995e+09,2.05842e+07
20071010,554500,509500,45000,-64000,1.1587e+10,5.58316e+09,2.08903e+07
20071011,554100,511600,42500,-155612,1.15554e+10,5.53849e+09,2.08427e+07
20071012,554400,515100,39300,133819,1.15842e+10,5.5683e+09,2.10059e+07
20071015,553800,493300,60500,-181188,1.15493e+10,5.49865e+09,1.92116e+07
20071016,555000,474600,80400,-113585,1.15236e+10,5.47922e+09,1.76922e+07
20071017,557100,444000,113100,37267,1.15297e+10,5.49802e+09,1.59287e+07
20071018,558000,426800,131200,101616,1.15476e+10,5.523e+09,1.44513e+07
20071019,560300,368300,192000,-256677,1.1495e+10,5.40215e+09,9.80158e+06
20071022,561500,320300,241200,-8741,1.1495e+10,5.45032e+09,6.49266e+06
20071023,560900,303500,257400,128392,1.15215e+10,5.50559e+09,4.9384e+06
20071024,562000,273600,288400,40320,1.15281e+10,5.51683e+09,2.84319e+06
20071025,562600,240700,321900,132871,1.15557e+10,5.53457e+09,261795
20071026,562200,248500,313700,-7438,1.15541e+10,5.59149e+09,754415
20071029,561800,257800,304000,33858,1.15625e+10,5.60979e+09,1.56811e+06
20071030,560800,284600,276200,-54477,1.15534e+10,5.56321e+09,3.5362e+06
20071031,559900,318100,241800,114573,1.15745e+10,5.63171e+09,6.31975e+06
20071101,559400,334000,225400,-121913,1.15534e+10,5.48532e+09,7.05941e+06
20071102,558500,338000,220500,126371,1.15802e+10,5.48452e+09,7.16812e+06
20071105,558300,303700,254600,64512,1.15931e+10,5.43825e+09,4.77159e+06
20071106,558400,293300,265100,99793,1.16175e+10,5.50464e+09,4.0388e+06
20071107,559400,267900,291500,17683,1.16178e+10,5.36633e+09,1.77169e+06
20071108,560200,247600,312600,11124,1.16181e+10,5.3817e+09,938088
20071109,561700,217400,344300,-51241,1.16057e+10,5.3244e+09,-1.0369e+06
20071112,564000,196600,367400,-68989,1.15945e+10,5.28733e+09,-3.24923e+06
20071113,564100,182900,381200,-233170,1.15473e+10,5.43625e+09,-4.97938e+06
20071114,563900,188100,375800,91610,1.15674e+10,5.40358e+09,-4.78747e+06
20071115,562400,182700,379700,123138,1.15896e+10,5.3296e+09,-5.58818e+06
20071116,561700,184700,377000,-5110,1.15843e+10,5.3376e+09,-5.59002e+06
20071119,561200,194700,366500,186779,1.16204e+10,5.24093e+09,-4.77372e+06
20071120,561300,183800,377500,-42532,1.16087e+10,5.25777e+09,-6.02065e+06
20071121,561600,167500,394100,108622,1.16281e+10,5.18994e+09,-7.32486e+06
20071123,562400,141600,420800,-192163,1.15921e+10,5.26941e+09,-8.654e+06
20071126,562800,136400,426400,277916,1.16422e+10,5.1658e+09,-9.3425e+06
20071127,563000,137000,426000,-162514,1.16113e+10,5.23956e+09,-9.2213e+06
20071128,563300,154000,409300,-311871,1.15536e+10,5.4113e+09,-8.11314e+06
20071129,562900,212800,350100,-24735,1.15526e+10,5.39483e+09,-2.99787e+06
20071130,562100,270000,292100,-7483,1.15539e+10,5.43162e+09,1.79718e+06
20071203,560600,359800,200800,4880,1.15552e+10,5.40064e+09,8.77216e+06
20071204,560300,416600,143700,-64831,1.15408e+10,5.35774e+09,1.28587e+07
20071205,560300,443400,116900,196598,1.15741e+10,5.43971e+09,1.49898e+07
20071206,560300,472900,87400,218707,1.16149e+10,5.53066e+09,1.75131e+07
20071207,559100,490900,68200,11850,1.16174e+10,5.52518e+09,1.86603e+07
20071210,559500,510500,49000,176607,1.16509e+10,5.57619e+09,2.00172e+07
20071211,564000,509300,54700,-646274,1.15308e+10,5.431e+09,1.9678e+07
20071212,565000,504400,60600,111820,1.15518e+10,5.4663e+09,1.9465e+07
20071213,566700,500000,66700,15178,1.15559e+10,5.49348e+09,1.89309e+07
20071214,568600,476800,91800,-247895,1.151e+10,5.43181e+09,1.69363e+07
20071217,576300,402100,174200,-193859,1.14749e+10,5.41536e+09,1.16012e+07
20071218,579800,368000,211800,54312,1.14826e+10,5.46925e+09,9.37811e+06
20071219,581700,343700,238000,8507,1.14852e+10,5.49583e+09,7.64464e+06
20071220,583600,304200,279400,126154,1.15067e+10,5.53966e+09,4.48715e+06
20071221,583600,297800,285800,53706,1.15216e+10,5.62741e+09,3.8343e+06
20071224,583700,317200,266500,20843,1.15272e+10,5.68315e+09,5.24494e+06
20071226,582800,322700,260100,53047,1.15361e+10,5.67374e+09,6.04369e+06
20071227,582600,335400,247200,-79203,1.15203e+10,5.59223e+09,7.24195e+06
20071228,583100,348300,234800,41728,1.15291e+10,5.59958e+09,8.51463e+06
20071231,583200,360400,222800,-96542,1.15078e+10,5.57307e+09,9.03277e+06
20080102,585100,332800,252300,-61107,1.14966e+10,5.4995e+09,6.47226e+06
20080103,587600,280100,307500,90109,1.15065e+10,5.50756e+09,2.60776e+06
20080104,593400,195600,397800,136636,1.15253e+10,5.41063e+09,-3.59877e+06
20080107,595700,143100,452600,-2555,1.15253e+10,5.4357e+09,-7.97852e+06
20080108,597500,119900,477600,289806,1.15746e+10,5.34138e+09,-1.00867e+07
20080109,597000,112000,485000,-64193,1.1567e+10,5.4005e+09,-1.05059e+07
20080110,596600,116500,480100,-205622,1.15336e+10,5.45434e+09,-1.06007e+07
20080111,596400,120000,476400,292805,1.15878e+10,5.37252e+09,-1.00927e+07
20080114,596600,131500,465100,-108019,1.15648e+10,5.43164e+09,-9.36424e+06
20080115,597400,136400,461000,284168,1.16189e+10,5.2978e+09,-8.96244e+06
20080116,597800,138300,459500,-36554,1.16167e+10,5.28407e+09,-9.02059e+06
20080117,598400,122700,475700,314061,1.16744e+10,5.11278e+09,-1.04171e+07
20080118,600300,114100,486200,18351,1.16721e+10,5.10375e+09,-1.20237e+07
20080122,602000,92700,509300,70610,1.16818e+10,5.09826e+09,-1.4616e+07
20080123,599100,115100,484000,-355189,1.16193e+10,5.22479e+09,-1.43055e+07
20080124,599400,132500,466900,-198691,1.15827e+10,5.27251e+09,-1.34883e+07
20080125,611400,198100,413300,112061,1.16106e+10,5.34989e+09,-1.03964e+07
20080128,615600,234700,380900,-60528,1.15997e+10,5.48998e+09,-8.03372e+06
20080129,616200,271400,344800,-7031,1.1598e+10,5.51896e+09,-5.24665e+06
20080130,616400,305400,311000,-10006,1.15942e+10,5.48365e+09,-3.10383e+06
20080131,616200,350600,265600,146229,1.16144e+10,5.59569e+09,22693
20080201,615900,418500,197400,166635,1.16468e+10,5.71246e+09,5.91245e+06
20080204,615000,441600,173400,-219937,1.16081e+10,5.65251e+09,7.68898e+06
20080205,615900,451600,164300,-253507,1.15537e+10,5.46724e+09,8.48261e+06
20080206,616000,464700,151300,-49148,1.15447e+10,5.41645e+09,8.99888e+06
20080207,616700,467600,149100,166472,1.15718e+10,5.48633e+09,9.72674e+06
20080208,618500,455400,163100,-54376,1.15602e+10,5.48608e+09,8.38225e+06
20080211,621600,428300,193300,82313,1.15733e+10,5.55124e+09,6.04239e+06
20080212,622600,435100,187500,26610,1.15768e+10,5.59588e+09,7.0141e+06
20080213,623800,446400,177400,101326,1.15972e+10,5.66699e+09,8.78622e+06
20080214,624700,457500,167200,-129364,1.15789e+10,5.59259e+09,9.80288e+06
20080215,624300,473900,150400,-9873,1.15775e+10,5.59238e+09,1.11136e+07
20080219,625300,458000,167300,60149,1.1589e+10,5.59539e+09,1.01971e+07
20080220,626300,446900,179400,79085,1.16002e+10,5.66135e+09,9.48654e+06
20080221,626900,429500,197400,-117267,1.15807e+10,5.59339e+09,8.40855e+06
20080222,628200,412100,216100,35444,1.15867e+10,5.6558e+09,7.97343e+06
20080225,630300,409500,220800,134280,1.16099e+10,5.76757e+09,8.26302e+06
20080226,629100,435000,194100,63480,1.16224e+10,5.80279e+09,1.02269e+07
20080227,628400,453000,175400,-15741,1.16201e+10,5.78919e+09,1.1683e+07
20080228,627800,478800,149000,-78206,1.16152e+10,5.73046e+09,1.28137e+07
20080229,627600,435400,192200,-277746,1.15762e+10,5.57091e+09,1.08467e+07
20080303,629100,416500,212600,64507,1.15879e+10,5.59795e+09,9.26338e+06
20080304,633100,377400,255700,-54481,1.15786e+10,5.59503e+09,6.65179e+06
20080305,638200,310700,327500,95500,1.15935e+10,5.6857e+09,2.66458e+06
20080306,641300,229100,412200,127600,1.16167e+10,5.57213e+09,-2.29919e+06
20080307,643400,188500,454900,-11689,1.16155e+10,5.53377e+09,-5.17308e+06
20080310,646900,149700,497200,235241,1.16593e+10,5.45387e+09,-8.61414e+06
20080311,647400,147600,499800,-381152,1.15892e+10,5.67328e+09,-9.47463e+06
20080312,647800,125000,522800,115922,1.1608e+10,5.64112e+09,-1.1324e+07
20080313,648400,133500,514900,-46440,1.15985e+10,5.69053e+09,-1.07611e+07
20080314,648700,143700,505000,246172,1.16425e+10,5.5832e+09,-9.86196e+06
20080317,648400,173400,475000,152592,1.16665e+10,5.49575e+09,-7.39909e+06
20080318,648000,183400,464600,-283705,1.16298e+10,5.72367e+09,-6.76991e+06
20080319,647400,189900,457500,106320,1.16408e+10,5.57379e+09,-6.3156e+06
20080320,645800,232500,413300,-41652,1.16345e+10,5.67842e+09,-4.10694e+06
20080324,640700,285100,355600,-28483,1.16316e+10,5.73858e+09,181482
20080325,635500,401200,234300,-44025,1.16203e+10,5.73601e+09,7.69806e+06
20080326,636000,418200,217800,-205163,1.15834e+10,5.69115e+09,8.78502e+06
20080327,636200,495500,140700,-141959,1.15551e+10,5.63715e+09,1.22029e+07
20080328,637000,512500,124500,-160783,1.15242e+10,5.59799e+09,1.3796e+07
20080331,637600,505900,131700,114953,1.15381e+10,5.64693e+09,1.37909e+07
20080401,636700,509100,127600,600988,1.1648e+10,5.85563e+09,1.52241e+07
20080402,636100,519600,116500,9844,1.16499e+10,5.85875e+09,1.58954e+07
20080403,634800,541900,92900,27364,1.16536e+10,5.86988e+09,1.75119e+07
20080404,634500,583800,50700,8175,1.1659e+10,5.87136e+09,1.91454e+07
20080407,634300,596700,37600,9974,1.16637e+10,5.8802e+09,2.04766e+07
20080408,635000,599300,35700,-79613,1.16505e+10,5.87104e+09,2.05223e+07
20080409,637500,597800,39700,-235161,1.16063e+10,5.8444e+09,2.01742e+07
20080410,639300,572000,67300,89690,1.16226e+10,5.88537e+09,1.93208e+07
20080411,641600,553300,88300,-293803,1.15671e+10,5.80133e+09,1.79301e+07
20080414,651400,495100,156300,55976,1.15741e+10,5.88724e+09,1.42916e+07
20080415,656900,417400,239500,56871,1.15835e+10,5.97445e+09,9.67319e+06
20080416,658300,406400,251900,277545,1.16387e+10,6.18237e+09,9.0653e+06
20080417,657200,398000,259200,-52006,1.16305e+10,6.173e+09,8.51239e+06
20080418,656000,408400,247600,161874,1.16689e+10,6.23706e+09,9.50995e+06
20080421,654500,452200,202300,33208,1.16742e+10,6.23025e+09,1.22468e+07
20080422,653400,472700,180700,-152774,1.16442e+10,6.14526e+09,1.38229e+07
20080423,652900,477100,175800,75057,1.16622e+10,6.15014e+09,1.4025e+07
20080424,652100,489900,162200,81332,1.16773e+10,6.17438e+09,1.43312e+07
20080425,651200,478400,172800,136534,1.1701e+10,6.2381e+09,1.37102e+07
20080428,650900,487100,163800,-23548,1.16957e+10,6.23322e+09,1.43197e+07
20080429,648800,525900,122900,-81666,1.16772e+10,6.19833e+09,1.58399e+07
20080430,643500,524200,119300,-87153,1.16631e+10,6.11555e+09,1.53626e+07
20080501,641200,538600,102600,336487,1.17261e+10,6.20093e+09,1.66125e+07
20080502,639900,545100,94800,39199,1.17344e+10,6.19959e+09,1.72152e+07
20080505,639400,550800,88600,-96379,1.17157e+10,6.16879e+09,1.68697e+07
20080506,638100,567100,71000,143256,1.17445e+10,6.20862e+09,1.75879e+07
20080507,637500,577000,60500,-338778,1.16783e+10,6.09084e+09,1.80803e+07
20080508,638200,552900,85300,59848,1.16925e+10,6.13074e+09,1.71724e+07
20080509,637700,539600,98100,-62531,1.168e+10,6.08818e+09,1.60275e+07
20080512,637000,522200,114800,203185,1.1722e+10,6.1722e+09,1.53798e+07
20080513,636600,493800,142800,72717,1.17371e+10,6.17871e+09,1.37296e+07
20080514,636800,489100,147700,49686,1.17439e+10,6.21146e+09,1.37132e+07
20080515,634400,498500,135900,156283,1.17747e+10,6.24804e+09,1.47941e+07
20080516,633000,525100,107900,2112,1.17755e+10,6.24339e+09,1.67219e+07
20080519,631400,541500,89900,-16732,1.17698e+10,6.22994e+09,1.79567e+07
20080520,630400,534400,96000,-145574,1.17441e+10,6.18401e+09,1.75531e+07
20080521,631100,521400,109700,-261117,1.16996e+10,6.08436e+09,1.62272e+07
20080522,630400,478300,152100,2087,1.17033e+10,6.06979e+09,1.43267e+07
20080523,633800,422200,211600,-110697,1.16833e+10,6.03182e+09,1.038e+07
20080527,634200,374800,259400,34101,1.16887e+10,6.08233e+09,7.09123e+06
20080528,633600,352100,281500,64855,1.17029e+10,6.11891e+09,5.40216e+06
20080529,630500,343600,286900,-70475,1.16995e+10,6.08679e+09,5.33523e+06
20080530,629400,342700,286700,78817,1.17151e+10,6.09169e+09,5.48172e+06
20080602,628700,374200,254500,-33422,1.17066e+10,6.0189e+09,7.16868e+06
20080603,628300,394800,233500,-3498,1.17054e+10,5.99287e+09,8.37769e+06
20080604,629800,392200,237600,63524,1.17218e+10,6.01085e+09,8.00521e+06
20080605,628300,384200,244100,150126,1.17515e+10,6.11824e+09,7.97108e+06
20080606,628600,370100,258500,-98807,1.17195e+10,5.92003e+09,6.1524e+06
20080609,629600,320200,309400,84604,1.17338e+10,5.93077e+09,4.10466e+06
20080610,629900,309700,320200,-65693,1.17216e+10,5.91781e+09,3.3389e+06
20080611,630600,285200,345400,70159,1.17281e+10,5.80658e+09,2.16378e+06
20080612,630600,230400,400200,-67524,1.17155e+10,5.83454e+09,-2.5424e+06
20080613,631300,225400,405900,-57732,1.17033e+10,5.94781e+09,-3.28964e+06
20080616,631200,220400,410800,-17248,1.16991e+10,5.96565e+09,-3.90362e+06
20080617,630800,215800,415000,148788,1.17217e+10,5.91673e+09,-3.76914e+06
20080618,630400,243300,387100,121506,1.17431e+10,5.85582e+09,-1.25257e+06
20080619,630300,243200,387100,-63191,1.17321e+10,5.89179e+09,-1.21991e+06
20080620,631600,221300,410300,89935,1.17432e+10,5.80133e+09,-2.80188e+06
20080623,631800,191600,440200,178700,1.17766e+10,5.79627e+09,-4.81634e+06
20080624,633900,164800,469100,-64322,1.1762e+10,5.77067e+09,-6.44907e+06
20080625,633200,159500,473700,-82694,1.17475e+10,5.80025e+09,-7.15213e+06
20080626,635200,123900,511300,374430,1.18166e+10,5.66018e+09,-9.7046e+06
20080627,635300,111200,524100,106730,1.18355e+10,5.64299e+09,-1.06875e+07
20080630,635600,100300,535300,94487,1.18478e+10,5.62912e+09,-1.15142e+07
20080701,637300,93900,543400,4122,1.18477e+10,5.66812e+09,-1.23072e+07
20080702,638500,84300,554200,246115,1.18968e+10,5.55548e+09,-1.26665e+07
20080703,637300,80500,556800,37206,1.19061e+10,5.52776e+09,-1.29254e+07
20080707,637700,79200,558500,95193,1.19222e+10,5.47343e+09,-1.35356e+07
20080708,637100,90000,547100,-385670,1.18544e+10,5.58663e+09,-1.31294e+07
20080709,637600,96200,541400,443353,1.19373e+10,5.46183e+09,-1.26546e+07
20080710,637000,107300,529700,-23197,1.19286e+10,5.48141e+09,-1.19359e+07
20080711,639400,120900,518500,101250,1.19498e+10,5.46545e+09,-1.07826e+07
20080714,640700,139800,500900,135663,1.19733e+10,5.42324e+09,-9.51122e+06
20080715,641200,144700,496500,160999,1.20058e+10,5.37198e+09,-8.98054e+06
20080716,642600,163100,479500,-405494,1.19332e+10,5.54601e+09,-8.45452e+06
20080717,641800,188100,453700,-174184,1.19042e+10,5.59006e+09,-7.83984e+06
20080718,647700,277900,369800,-17840,1.18997e+10,5.65443e+09,-2.5631e+06
20080721,652300,359600,292700,-96408,1.18822e+10,5.69985e+09,1.51528e+06
20080722,658900,436000,222900,294695,1.19307e+10,5.85285e+09,6.11018e+06
20080723,665900,502800,163100,220411,1.19632e+10,5.92649e+09,1.06598e+07
20080724,670500,509600,160900,-405692,1.1889e+10,5.79268e+09,1.0416e+07
20080725,674300,514000,160300,28985,1.18963e+10,5.85802e+09,1.03577e+07
20080728,676100,522200,153900,-278802,1.18456e+10,5.78309e+09,1.0297e+07
20080729,679700,499400,180300,453087,1.19273e+10,5.97648e+09,9.97546e+06
20080730,681900,488300,193600,-48398,1.19174e+10,6.08083e+09,9.10434e+06
20080731,685100,472300,212800,26380,1.19219e+10,6.02277e+09,9.3085e+06
20080801,686800,471100,215700,-2908,1.19174e+10,5.98158e+09,9.45774e+06
20080804,688300,480900,207400,59017,1.19321e+10,5.91377e+09,9.83044e+06
20080805,688700,509400,179300,459052,1.20082e+10,6.08647e+09,1.19018e+07
20080806,688700,506000,182700,-21495,1.20007e+10,6.12106e+09,1.14301e+07
20080807,689100,519100,170000,-233490,1.19629e+10,6.0094e+09,1.13421e+07
20080808,688000,524400,163600,546522,1.20563e+10,6.15451e+09,1.22259e+07
20080811,685900,560900,125000,255474,1.21016e+10,6.18788e+09,1.46261e+07
20080812,690000,573300,116700,-275228,1.20555e+10,6.1313e+09,1.50256e+07
20080813,691600,561300,130300,-255746,1.20068e+10,6.13109e+09,1.43184e+07
20080814,693900,577400,116500,246086,1.20498e+10,6.19813e+09,1.48365e+07
20080815,693800,570100,123700,189004,1.20829e+10,6.22588e+09,1.4767e+07
20080818,694000,570200,123800,-253697,1.20365e+10,6.13081e+09,1.4622e+07
20080819,694900,551800,143100,-288607,1.19804e+10,6.07779e+09,1.3895e+07
20080820,695200,567700,127500,-31115,1.19738e+10,6.11908e+09,1.36821e+07
20080821,696600,556000,140600,4834,1.19751e+10,6.12798e+09,1.30514e+07
20080822,697600,509300,188300,128067,1.19963e+10,6.21076e+09,1.18337e+07
20080825,698100,443000,255100,-132015,1.19768e+10,6.09294e+09,9.42911e+06
20080826,698000,432500,265500,59378,1.1991e+10,6.11675e+09,9.16227e+06
20080827,699600,431700,267900,92679,1.20078e+10,6.19111e+09,9.34792e+06
20080828,698700,464500,234200,104695,1.20246e+10,6.28752e+09,1.13802e+07
20080829,696000,460200,235800,-118442,1.2001e+10,6.19346e+09,1.01297e+07
20080902,690400,464500,225900,-52431,1.19856e+10,6.12544e+09,1.03476e+07
20080903,690000,465300,224700,30560,1.19905e+10,6.13973e+09,1.09573e+07
20080904,694400,445800,248600,-240928,1.19479e+10,5.98835e+09,8.68956e+06
20080905,696800,389900,306900,105110,1.1968e+10,6.03813e+09,3.272e+06
20080908,696300,385300,311000,397378,1.20287e+10,6.1556e+09,2.81468e+06
20080909,697500,376600,320900,40221,1.20437e+10,5.93548e+09,1.77412e+06
20080910,697900,342300,355600,-157739,1.20135e+10,5.99319e+09,-69380
20080911,697800,349000,348800,999,1.20114e+10,6.08538e+09,-181746
20080912,696100,377400,318700,-76965,1.19961e+10,6.10903e+09,1.30787e+06
20080915,698500,356100,342400,147498,1.20334e+10,5.86378e+09,-302369
20080916,700900,351100,349800,83132,1.20366e+10,6.0134e+09,21734
20080917,705300,306500,398800,230329,1.20961e+10,5.77671e+09,-3.21092e+06
20080918,707000,273300,433700,25918,1.20799e+10,6.05872e+09,-3.96532e+06
20080919,704800,262100,442700,-439719,1.19858e+10,6.27851e+09,-4.91362e+06
20080922,703900,289800,414100,13349,1.20021e+10,5.99183e+09,-3.78747e+06
20080923,701600,269500,432100,51513,1.20173e+10,5.87052e+09,-5.13285e+06
20080924,701800,281900,419900,77,1.20169e+10,5.84416e+09,-4.55648e+06
20080925,703000,285900,417100,-37931,1.20104e+10,5.94009e+09,-4.18449e+06
20080926,704700,259800,444900,40235,1.20132e+10,5.95655e+09,-5.53725e+06
20080929,710300,215800,494500,670011,1.21346e+10,5.52235e+09,-8.43772e+06
20080930,716100,185000,531100,-421323,1.20698e+10,5.82267e+09,-9.30593e+06
20081001,717300,168400,548900,149741,1.20989e+10,5.77038e+09,-9.90487e+06
20081002,725300,107800,617500,896632,1.22708e+10,5.52397e+09,-1.2487e+07
20081003,727200,85100,642100,198931,1.23036e+10,5.444e+09,-1.41961e+07
20081006,726700,81000,645700,620792,1.24263e+10,5.23307e+09,-1.40104e+07
20081007,730000,60700,669300,929170,1.26061e+10,4.96628e+09,-1.45176e+07
20081008,733400,24600,708800,188964,1.26422e+10,4.95736e+09,-1.67947e+07
20081009,736300,11200,725100,1.32655e+06,1.28873e+10,4.60339e+09,-1.65687e+07
20081010,739700,800,738900,113450,1.29235e+10,4.62745e+09,-1.68975e+07
20081013,739700,800,738900,-1.85464e+06,1.25624e+10,5.12572e+09,-1.87521e+07
20081014,739700,800,738900,88962,1.25798e+10,5.07464e+09,-1.86631e+07
20081015,739800,100,739700,1.77951e+06,1.29155e+10,4.57014e+09,-1.70102e+07
20081016,739800,2600,737200,-646274,1.27952e+10,4.75971e+09,-1.74432e+07
20081017,739000,25300,713700,68441,1.27991e+10,4.71812e+09,-1.70455e+07
20081020,737900,40400,697500,-732615,1.2658e+10,4.90282e+09,-1.74832e+07
20081021,736700,42900,693800,588800,1.27632e+10,4.72572e+09,-1.65327e+07
20081022,737600,52100,685500,979792,1.29481e+10,4.43919e+09,-1.50904e+07
20081023,737800,63900,673900,77202,1.29565e+10,4.41682e+09,-1.4343e+07
20081024,738800,68000,670800,502147,1.30532e+10,4.27212e+09,-1.3479e+07
20081027,745700,46500,699200,475536,1.31481e+10,4.145e+09,-1.34558e+07
20081028,746800,62700,684100,-1.3535e+06,1.28964e+10,4.57623e+09,-1.3973e+07
20081029,746500,103000,643500,65065,1.29136e+10,4.5801e+09,-1.11894e+07
20081030,749100,147100,602000,-315099,1.28661e+10,4.75981e+09,-9.37634e+06
20081031,754100,260900,493200,-190224,1.28324e+10,4.9083e+09,-3.57066e+06
20081103,783200,469200,314000,-53727,1.28178e+10,5.07293e+09,5.79132e+06
20081104,817200,582300,234900,399074,1.28928e+10,5.52659e+09,1.12172e+07
20081105,839700,642500,197200,-724268,1.2764e+10,5.31739e+09,1.3561e+07
20081106,849900,644400,205500,-620401,1.26504e+10,5.10118e+09,1.22328e+07
20081107,855300,619800,235500,338190,1.27178e+10,5.28583e+09,1.15804e+07
20081110,867800,565600,302200,-41656,1.27126e+10,5.27111e+09,9.24961e+06
20081111,895900,453500,442400,20246,1.27088e+10,5.30154e+09,3.66914e+06
20081112,945900,268000,677900,396740,1.27725e+10,5.24954e+09,-3.4945e+06
20081113,947200,267000,680200,-299546,1.27356e+10,5.63232e+09,-3.73766e+06
20081114,958200,226200,732000,467701,1.2813e+10,5.43016e+09,-5.67699e+06
20081117,961900,204500,757400,339320,1.28709e+10,5.28646e+09,-6.89868e+06
20081118,968300,190700,777600,84187,1.28844e+10,5.35489e+09,-8.07346e+06
20081119,971200,177200,794000,841499,1.30313e+10,5.01796e+09,-7.9728e+06
20081120,984900,109700,875200,928591,1.32009e+10,4.76125e+09,-1.17773e+07
20081121,988700,74500,914200,-855648,1.30457e+10,5.08268e+09,-1.43058e+07
20081124,989700,59500,930200,-1.30543e+06,1.28133e+10,5.45792e+09,-1.64244e+07
20081125,988900,61300,927600,-260698,1.27602e+10,5.5241e+09,-1.65205e+07
20081126,985600,94700,890900,-734210,1.263e+10,5.73751e+09,-1.51801e+07
20081128,986400,240600,745800,-52679,1.26234e+10,5.78199e+09,-7.60896e+06
20081201,995400,357700,637700,444061,1.26897e+10,5.22332e+09,-3.05385e+06
20081202,1.0605e+06,499900,560600,-93973,1.26789e+10,5.8212e+09,-792405
20081203,1.074e+06,620800,453200,179328,1.27152e+10,6.08298e+09,3.72472e+06
20081204,1.0774e+06,619800,457600,10505,1.27165e+10,5.94852e+09,3.18524e+06
20081205,1.0876e+06,626700,460900,179732,1.27521e+10,6.28972e+09,2.8792e+06
20081208,1.1034e+06,825900,277500,309562,1.28097e+10,6.64843e+09,9.82841e+06
20081209,1.1498e+06,927900,221900,-381524,1.27414e+10,6.79253e+09,1.23517e+07
20081210,1.1523e+06,968800,183500,208048,1.2781e+10,6.91788e+09,1.43594e+07
20081211,1.1595e+06,981400,178100,-787156,1.26397e+10,6.69788e+09,1.47249e+07
20081212,1.1797e+06,991300,188400,339924,1.26965e+10,6.82282e+09,1.57241e+07
20081215,1.1827e+06,988400,194300,-339967,1.26358e+10,6.73054e+09,1.49235e+07
20081216,1.1857e+06,1.0065e+06,179200,1.06905e+06,1.28374e+10,7.16497e+09,1.6082e+07
20081217,1.1866e+06,1.0046e+06,182000,2354,1.28357e+10,7.15403e+09,1.60898e+07
20081218,1.1932e+06,1.0279e+06,165300,-376213,1.27657e+10,7.05156e+09,1.60935e+07
20081219,1.1953e+06,1.0076e+06,187700,197712,1.28017e+10,7.10697e+09,1.55182e+07
20081222,1.1965e+06,1.0035e+06,193000,-447741,1.27207e+10,6.9389e+09,1.47066e+07
20081223,1.2238e+06,843900,379900,-97672,1.27034e+10,7.0488e+09,1.08267e+07
20081224,1.2194e+06,713100,506300,29188,1.2709e+10,7.04152e+09,8.3934e+06
20081226,1.222e+06,654700,567300,68316,1.27211e+10,7.1035e+09,7.16336e+06
20081229,1.2223e+06,603300,619000,-88555,1.2707e+10,7.0473e+09,5.40086e+06
20081230,1.2236e+06,588600,635000,171100,1.27392e+10,7.26967e+09,5.29064e+06
20081231,1.227e+06,627500,599500,64644,1.27551e+10,7.42563e+09,7.00629e+06
20090102,1.2179e+06,753600,464300,380111,1.28305e+10,7.59851e+09,1.27628e+07
20090105,1.2082e+06,935500,272700,53133,1.28367e+10,7.53593e+09,1.73133e+07
20090106,1.1709e+06,1.0154e+06,155500,311431,1.28806e+10,7.35966e+09,2.08958e+07
20090107,1.1346e+06,1.0603e+06,74300,-759532,1.27443e+10,6.92448e+09,2.13052e+07
20090108,1.1342e+06,1.0677e+06,66500,151989,1.2778e+10,6.92892e+09,2.13224e+07
20090109,1.1367e+06,1.0554e+06,81300,-456693,1.26903e+10,6.76486e+09,1.84463e+07
20090112,1.1389e+06,992700,146200,-455442,1.26026e+10,6.60429e+09,1.55109e+07
20090113,1.1489e+06,875700,273200,-32327,1.25981e+10,6.68007e+09,1.0478e+07
20090114,1.1602e+06,737500,422700,-57358,1.25861e+10,6.49551e+09,3.65537e+06
20090115,1.1748e+06,562500,612300,121379,1.26127e+10,6.64732e+09,-1.7634e+06
20090116,1.2045e+06,461200,743300,-18225,1.26126e+10,6.88817e+09,-4.29542e+06
20090120,1.2311e+06,284100,947000,944153,1.27758e+10,6.62989e+09,-9.1409e+06
20090121,1.2299e+06,272500,957400,-638813,1.26569e+10,6.91803e+09,-1.0249e+07
20090122,1.2299e+06,263400,966500,434068,1.27386e+10,6.79757e+09,-1.01353e+07
20090123,1.2308e+06,259100,971700,-163219,1.27052e+10,6.83566e+09,-1.02687e+07
20090126,1.2299e+06,261200,968700,27869,1.27112e+10,6.88039e+09,-9.83782e+06
20090127,1.2244e+06,284500,939900,-100401,1.26947e+10,6.95535e+09,-8.12488e+06
20090128,1.218e+06,341900,876100,-536335,1.26063e+10,7.2052e+09,-6.43482e+06
20090129,1.213e+06,398800,814200,445103,1.26811e+10,6.90596e+09,-2.89987e+06
20090130,1.2127e+06,418400,794300,163983,1.27078e+10,6.74768e+09,-1.79007e+06
20090202,1.2136e+06,419500,794100,90695,1.27221e+10,6.71609e+09,-922839
20090203,1.2116e+06,430100,781500,28015,1.27253e+10,6.81286e+09,-359274
20090204,1.2134e+06,404300,809100,100093,1.27332e+10,6.79979e+09,-747379
20090205,1.211e+06,437800,773200,67469,1.27555e+10,6.92373e+09,846242
20090206,1.1986e+06,556900,641700,-10398,1.27611e+10,7.04606e+09,5.59026e+06
20090209,1.1779e+06,671200,506700,-117056,1.27388e+10,6.87827e+09,9.31001e+06
20090210,1.178e+06,663900,514100,-306356,1.26631e+10,6.53783e+09,8.73776e+06
20090211,1.1777e+06,744200,433500,66808,1.26729e+10,6.63435e+09,1.02214e+07
20090212,1.1795e+06,754100,425400,79979,1.26964e+10,6.65109e+09,1.03659e+07
20090213,1.1852e+06,704000,481200,80002,1.27036e+10,6.60632e+09,7.73495e+06
20090217,1.2087e+06,543500,665200,52481,1.27182e+10,6.44535e+09,722782
20090218,1.2257e+06,406500,819200,88774,1.27367e+10,6.55396e+09,-2.52304e+06
20090219,1.2316e+06,355400,876200,184079,1.27726e+10,6.514e+09,-4.89438e+06
20090220,1.2434e+06,249300,994100,147689,1.28012e+10,6.52871e+09,-9.50756e+06
20090223,1.2556e+06,133000,1.1226e+06,600099,1.29104e+10,6.31607e+09,-1.36417e+07
20090224,1.2566e+06,119900,1.1367e+06,-806198,1.27676e+10,6.60526e+09,-1.50007e+07
20090225,1.2568e+06,128400,1.1284e+06,234221,1.28109e+10,6.51559e+09,-1.48553e+07
20090226,1.2584e+06,134700,1.1237e+06,217194,1.28539e+10,6.41752e+09,-1.58108e+07
20090227,1.2722e+06,190500,1.0817e+06,411994,1.29415e+10,6.33913e+09,-1.49417e+07
20090302,1.2961e+06,215600,1.0805e+06,885037,1.31035e+10,6.15914e+09,-1.44586e+07
20090303,1.3042e+06,194100,1.1101e+06,126310,1.3127e+10,6.14657e+09,-1.47766e+07
20090304,1.3044e+06,181200,1.1232e+06,-469732,1.30357e+10,6.31275e+09,-1.57135e+07
20090305,1.3186e+06,127300,1.1913e+06,871872,1.31992e+10,6.10669e+09,-1.55876e+07
20090306,1.3206e+06,108100,1.2125e+06,72316,1.3206e+10,6.08324e+09,-1.55005e+07
20090309,1.32e+06,115900,1.2041e+06,106464,1.32293e+10,6.02328e+09,-1.5187e+07
20090310,1.317e+06,175600,1.1414e+06,-1.00957e+06,1.30418e+10,6.40277e+09,-1.41518e+07
20090311,1.3153e+06,206900,1.1084e+06,-34270,1.30381e+10,6.41728e+09,-1.33212e+07
20090312,1.3098e+06,332300,977500,-423114,1.29613e+10,6.69004e+09,-9.82069e+06
20090313,1.3451e+06,580000,765100,-212716,1.29193e+10,6.94833e+09,-2.40194e+06
20090316,1.4008e+06,958200,442600,-215197,1.28812e+10,7.19363e+09,5.48657e+06
20090317,1.4224e+06,1.1334e+06,289000,507952,1.29744e+10,7.5519e+09,1.08279e+07
20090318,1.431e+06,1.2943e+06,136700,663219,1.31e+10,7.74483e+09,1.64495e+07
20090319,1.4418e+06,1.3671e+06,74700,-365092,1.30323e+10,7.69419e+09,1.88411e+07
20090320,1.4513e+06,1.3943e+06,57000,-587855,1.29271e+10,7.5772e+09,1.93218e+07
20090323,1.4571e+06,1.4224e+06,34700,1.80301e+06,1.32629e+10,8.15274e+09,2.222e+07
20090324,1.4592e+06,1.4272e+06,32000,-505098,1.31692e+10,8.00119e+09,2.19619e+07
20090325,1.4613e+06,1.4309e+06,30400,177318,1.32002e+10,8.07291e+09,2.24724e+07
20090326,1.4619e+06,1.44e+06,21900,796612,1.33429e+10,8.32689e+09,2.38124e+07
20090327,1.4638e+06,1.4379e+06,25900,-583790,1.32282e+10,8.15046e+09,2.31189e+07
20090330,1.4649e+06,1.4314e+06,33500,-988845,1.30362e+10,7.87201e+09,2.17748e+07
20090331,1.4665e+06,1.4255e+06,41000,376790,1.31078e+10,7.99603e+09,2.17343e+07
20090401,1.4666e+06,1.3935e+06,73100,374659,1.3175e+10,8.1202e+09,2.122e+07
20090402,1.4719e+06,1.3644e+06,107500,867368,1.33279e+10,8.46216e+09,2.1416e+07
20090403,1.4719e+06,1.3503e+06,121600,332280,1.33809e+10,8.61931e+09,2.162e+07
20090406,1.4716e+06,1.3747e+06,96900,-206702,1.33452e+10,8.53298e+09,2.20048e+07
20090407,1.4691e+06,1.3709e+06,98200,-694773,1.3219e+10,8.27893e+09,2.09359e+07
20090408,1.4711e+06,1.3806e+06,90500,384077,1.32857e+10,8.43171e+09,2.13949e+07
20090409,1.4662e+06,1.3629e+06,103300,1.32431e+06,1.3522e+10,8.77906e+09,2.2652e+07
20090413,1.4595e+06,1.3448e+06,114700,122911,1.35518e+10,8.76899e+09,2.23199e+07
20090414,1.4591e+06,1.3472e+06,111900,-616892,1.34433e+10,8.55667e+09,2.12356e+07
20090415,1.4568e+06,1.3581e+06,98700,420828,1.35187e+10,8.67546e+09,2.20126e+07
20090416,1.4519e+06,1.3629e+06,89000,599606,1.36228e+10,8.8094e+09,2.28015e+07
20090417,1.4502e+06,1.3646e+06,85600,343384,1.3673e+10,8.89068e+09,2.26753e+07
20090420,1.4514e+06,1.3588e+06,92600,-1.4331e+06,1.34154e+10,8.48041e+09,2.03878e+07
20090421,1.4623e+06,1.2535e+06,208800,776372,1.35532e+10,8.7878e+09,2.04285e+07
20090422,1.4652e+06,1.2417e+06,223500,101600,1.35695e+10,8.79061e+09,2.00541e+07
20090423,1.4636e+06,1.2315e+06,232100,222402,1.36097e+10,8.84812e+09,1.93551e+07
20090424,1.464e+06,1.2098e+06,254200,573761,1.37101e+10,9.05277e+09,1.89928e+07
20090427,1.4611e+06,1.194e+06,267100,-442297,1.3632e+10,8.91113e+09,1.84132e+07
20090428,1.4591e+06,1.1846e+06,274500,-124037,1.36117e+10,8.87151e+09,1.80022e+07
20090429,1.4509e+06,1.1622e+06,288700,559396,1.37096e+10,9.01649e+09,1.85891e+07
20090430,1.4489e+06,1.1281e+06,320800,120251,1.37338e+10,8.99405e+09,1.81694e+07
20090501,1.4319e+06,1.0708e+06,361100,27042,1.37394e+10,8.85596e+09,1.83411e+07
20090504,1.4226e+06,1.0699e+06,352700,834871,1.38837e+10,9.15776e+09,1.98955e+07
20090505,1.4139e+06,1.1113e+06,302600,-156440,1.38503e+10,9.07989e+09,2.15197e+07
20090506,1.364e+06,1.1756e+06,188400,401596,1.39222e+10,8.83856e+09,2.1963e+07
20090507,1.3358e+06,1.1811e+06,154700,-545572,1.38259e+10,8.45296e+09,2.20541e+07
20090508,1.3275e+06,1.195e+06,132500,947961,1.39911e+10,8.64619e+09,2.33954e+07
20090511,1.3259e+06,1.1918e+06,134100,-722775,1.38706e+10,8.41573e+09,2.26093e+07
20090512,1.3252e+06,1.164e+06,161200,-253676,1.38317e+10,8.36424e+09,2.1201e+07
20090513,1.3115e+06,1.0573e+06,254200,-793316,1.36897e+10,8.01533e+09,1.67005e+07
20090514,1.3057e+06,999200,306500,298826,1.37412e+10,8.08581e+09,1.45772e+07
20090515,1.2923e+06,895800,396500,-192345,1.37074e+10,7.93005e+09,1.0295e+07
20090518,1.2675e+06,809400,458100,319733,1.37627e+10,8.02043e+09,8.00397e+06
20090519,1.243e+06,751600,491400,5079,1.37671e+10,7.94247e+09,5.9446e+06
20090520,1.2405e+06,753600,486900,33587,1.37734e+10,7.86199e+09,6.06445e+06
20090521,1.2396e+06,758200,481400,-85719,1.37521e+10,7.7205e+09,5.89074e+06
20090522,1.2251e+06,772500,452600,47900,1.37585e+10,7.68534e+09,6.86781e+06
20090526,1.2147e+06,748900,465800,106517,1.37807e+10,7.85902e+09,6.0709e+06
20090527,1.1957e+06,679600,516100,-26260,1.37742e+10,7.56278e+09,4.05893e+06
20090528,1.1921e+06,680800,511300,152260,1.38026e+10,7.62704e+09,4.51845e+06
20090529,1.1892e+06,719700,469500,123137,1.38294e+10,7.7364e+09,7.06188e+06
20090601,1.168e+06,802300,365700,362015,1.38972e+10,7.83983e+09,1.18295e+07
20090602,1.1331e+06,830500,302600,-32994,1.38929e+10,7.60094e+09,1.49828e+07
20090603,1.1242e+06,861300,262900,-301609,1.38387e+10,7.45064e+09,1.64291e+07
20090604,1.1163e+06,920200,196100,260046,1.38871e+10,7.4897e+09,1.95843e+07
20090605,1.1117e+06,955500,156200,-36971,1.38807e+10,7.4325e+09,2.09875e+07
20090608,1.1106e+06,954500,156100,-80365,1.38613e+10,7.40102e+09,2.09831e+07
20090609,1.1101e+06,985300,124800,140591,1.38895e+10,7.44257e+09,2.09849e+07
20090610,1.1108e+06,995300,115500,-110308,1.3869e+10,7.40719e+09,2.07328e+07
20090611,1.1105e+06,976500,134000,96036,1.38908e+10,7.43377e+09,1.97509e+07
20090612,1.1055e+06,954600,150900,17496,1.38947e+10,7.40364e+09,1.93737e+07
20090615,1.1062e+06,937900,168300,-517341,1.37957e+10,7.21861e+09,1.80085e+07
20090616,1.0945e+06,887400,207100,-280493,1.37353e+10,7.0496e+09,1.49339e+07
20090617,1.0935e+06,811400,282100,-20441,1.37258e+10,7.02432e+09,1.14901e+07
20090618,1.091e+06,737500,353500,80426,1.37411e+10,7.06973e+09,8.10424e+06
20090619,1.0853e+06,602800,482500,-6202,1.37404e+10,7.04541e+09,2.40193e+06
20090622,1.0636e+06,397900,665700,267597,1.37944e+10,6.67707e+09,-2.56965e+06
20090623,1.0688e+06,322600,746200,-67922,1.37824e+10,6.70612e+09,-5.74358e+06
20090624,1.0684e+06,309000,759400,-107967,1.37583e+10,6.76039e+09,-7.17845e+06
20090625,1.0684e+06,300800,767600,-213729,1.3721e+10,6.90525e+09,-8.0838e+06
20090626,1.0684e+06,302700,765700,18959,1.37236e+10,6.89819e+09,-7.64265e+06
20090629,1.0644e+06,342300,722100,-41608,1.37183e+10,6.91555e+09,-5.75273e+06
20090630,1.0602e+06,402300,657900,50939,1.37271e+10,6.83672e+09,-2.39605e+06
20090701,1.0575e+06,499600,557900,35394,1.37333e+10,6.84605e+09,2.17567e+06
20090702,1.0571e+06,519400,537700,-13649,1.37302e+10,6.63082e+09,2.63379e+06
20090706,1.0589e+06,493600,565300,91980,1.37489e+10,6.66448e+09,2.25932e+06
20090707,1.0652e+06,428300,636900,100138,1.37651e+10,6.52267e+09,-287763
20090708,1.0679e+06,383300,684600,65203,1.37752e+10,6.52129e+09,-2.46556e+06
20090709,1.0706e+06,305200,765400,-134781,1.37513e+10,6.57574e+09,-6.2476e+06
20090710,1.0697e+06,283700,786000,38830,1.37566e+10,6.54741e+09,-7.19525e+06
20090713,1.0696e+06,282700,786900,-277117,1.37083e+10,6.71781e+09,-7.59255e+06
20090714,1.0692e+06,370500,698700,-68688,1.36948e+10,6.7689e+09,-4.65038e+06
20090715,1.0583e+06,489000,569300,-31099,1.3697e+10,6.90197e+09,892919
20090716,1.0496e+06,692700,356900,156613,1.37262e+10,6.92553e+09,1.10335e+07
20090717,1.0439e+06,909200,134700,-42293,1.37188e+10,6.88776e+09,1.74081e+07
20090720,1.0361e+06,953600,82500,347724,1.37802e+10,6.96517e+09,2.02971e+07
20090721,1.0307e+06,954000,76700,12561,1.37888e+10,6.92749e+09,2.13251e+07
20090722,1.0343e+06,924400,109900,74548,1.37992e+10,6.95135e+09,2.09404e+07
20090723,1.0351e+06,902300,132800,667909,1.3928e+10,7.17503e+09,2.15664e+07
20090724,1.0323e+06,934000,98300,171984,1.39623e+10,7.19304e+09,2.19145e+07
20090727,1.033e+06,944900,88100,63419,1.39727e+10,7.2217e+09,2.20685e+07
20090728,1.0311e+06,956000,75100,-85985,1.39587e+10,7.17034e+09,2.2323e+07
20090729,1.0303e+06,974200,56100,-122763,1.3937e+10,7.12359e+09,2.21941e+07
20090730,1.0276e+06,1.0072e+06,20400,374322,1.40014e+10,7.20395e+09,2.30509e+07
20090731,1.0239e+06,998000,25900,68618,1.40155e+10,7.21189e+09,2.28865e+07
20090803,1.0238e+06,992300,31500,422939,1.40947e+10,7.33857e+09,2.32997e+07
20090804,1.0238e+06,992800,31000,143748,1.412e+10,7.3719e+09,2.3345e+07
20090805,1.0232e+06,994400,28800,-2650,1.41192e+10,7.35047e+09,2.32062e+07
20090806,1.0233e+06,980500,42800,-126474,1.40971e+10,7.30572e+09,2.22306e+07
20090807,1.0219e+06,974500,47400,548419,1.41962e+10,7.44464e+09,2.2402e+07
20090810,1.0223e+06,957600,64700,-159310,1.41704e+10,7.39119e+09,2.11704e+07
20090811,1.0226e+06,935900,86700,-280621,1.41222e+10,7.30619e+09,1.94523e+07
20090812,1.022e+06,930000,92000,314482,1.41828e+10,7.39949e+09,1.95004e+07
20090813,1.0216e+06,926100,95500,162238,1.42129e+10,7.44185e+09,1.94254e+07
20090814,1.019e+06,875000,144000,-255482,1.41703e+10,7.31887e+09,1.87951e+07
20090817,1.0185e+06,860400,158100,-539529,1.40727e+10,7.1193e+09,1.70287e+07
20090818,1.0183e+06,851500,166800,225042,1.4114e+10,7.20574e+09,1.65359e+07
20090819,1.0163e+06,830000,186300,61093,1.41245e+10,7.23815e+09,1.48338e+07
20090820,1.0126e+06,791500,221100,175843,1.4155e+10,7.30023e+09,1.31309e+07
20090821,1.008e+06,777500,230500,306943,1.42099e+10,7.41635e+09,1.36753e+07
20090824,1.0051e+06,814200,190900,-33136,1.42087e+10,7.36551e+09,1.6544e+07
20090825,1.0006e+06,871200,129400,96320,1.42213e+10,7.37106e+09,1.99598e+07
20090826,995200,883300,111900,-29888,1.42139e+10,7.32e+09,2.10126e+07
20090827,985700,869000,116700,61465,1.42262e+10,7.29403e+09,2.10294e+07
20090828,976900,903700,73200,37745,1.42301e+10,7.20846e+09,2.10301e+07
20090831,975700,909800,65900,-205866,1.41918e+10,7.13312e+09,2.11605e+07
20090901,964900,846100,118800,-475149,1.41076e+10,6.89155e+09,1.89693e+07
20090902,965000,781800,183200,-55304,1.41001e+10,6.87797e+09,1.57083e+07
20090903,958000,702900,255100,119718,1.41219e+10,6.89366e+09,1.23793e+07
20090904,952700,665200,287500,128411,1.41468e+10,6.95909e+09,1.07511e+07
20090908,945300,613800,331500,68808,1.41587e+10,6.98981e+09,9.03733e+06
20090909,942000,667300,274700,109939,1.41831e+10,7.04203e+09,1.23692e+07
20090910,927600,739200,188400,233987,1.42255e+10,6.99815e+09,1.60551e+07
20090911,914000,777200,136800,-19146,1.42202e+10,6.88441e+09,1.87244e+07
20090914,907100,791000,116100,185890,1.42538e+10,6.89199e+09,1.96464e+07
20090915,900400,775900,124500,135428,1.42788e+10,6.86933e+09,1.97208e+07
20090916,896100,802000,94100,400162,1.43577e+10,6.96099e+09,2.11313e+07
20090917,893900,814200,79700,-151522,1.43277e+10,6.91924e+09,2.09551e+07
20090918,889300,821000,68300,55636,1.43406e+10,6.90314e+09,2.1542e+07
20090921,888900,820200,68700,-94912,1.43271e+10,6.86118e+09,2.14347e+07
20090922,888000,804400,83600,140606,1.43537e+10,6.90908e+09,2.08239e+07
20090923,888200,802400,85800,-289091,1.42984e+10,6.81865e+09,2.04261e+07
20090924,887900,785300,102600,-278833,1.42491e+10,6.7232e+09,1.95106e+07
20090925,887900,765500,122400,-127365,1.42245e+10,6.68077e+09,1.8535e+07
20090928,886600,756600,130000,405967,1.43045e+10,6.80363e+09,1.79759e+07
20090929,887500,743600,143900,-15388,1.43018e+10,6.78873e+09,1.66313e+07
20090930,886400,723700,162700,-10742,1.43003e+10,6.76045e+09,1.52727e+07
20091001,885300,688000,197300,-394524,1.42233e+10,6.57466e+09,1.26141e+07
20091002,885100,644300,240800,-30035,1.42171e+10,6.51322e+09,1.01784e+07
20091005,879900,501100,378800,77498,1.42348e+10,6.58868e+09,4.73047e+06
20091006,878400,421300,457100,44990,1.42482e+10,6.65346e+09,1.61262e+06
20091007,877400,371800,505600,36242,1.42558e+10,6.6577e+09,-780812
20091008,872900,395500,477400,-18412,1.42538e+10,6.68731e+09,809829
20091009,865100,489600,375500,19559,1.42577e+10,6.67162e+09,5.84279e+06
20091012,860000,544000,316000,56219,1.42691e+10,6.64946e+09,9.34684e+06
20091013,856500,574300,282200,-33793,1.42605e+10,6.60997e+09,1.11954e+07
20091014,849800,642900,206900,279697,1.43206e+10,6.69084e+09,1.51854e+07
20091015,845400,675100,170300,72577,1.4333e+10,6.68716e+09,1.71169e+07
20091016,843500,695600,147900,-123090,1.43074e+10,6.63175e+09,1.82947e+07
20091019,841100,740900,100200,231643,1.43511e+10,6.6969e+09,1.95453e+07
20091020,838900,733500,105400,-140361,1.43253e+10,6.62494e+09,1.9592e+07
20091021,841000,717600,123400,-174179,1.42926e+10,6.56278e+09,1.9181e+07
20091022,841300,691500,149800,232964,1.4334e+10,6.65517e+09,1.86256e+07
20091023,842400,654900,187500,-231073,1.4291e+10,6.59005e+09,1.76722e+07
20091026,845200,621200,224000,-130322,1.42668e+10,6.54265e+09,1.57511e+07
20091027,848700,562600,286100,-95746,1.42494e+10,6.50563e+09,1.26875e+07
20091028,856400,484500,371900,-204052,1.42165e+10,6.40607e+09,8.4109e+06
20091029,855800,408500,447300,35563,1.42207e+10,6.55555e+09,4.29315e+06
20091030,861000,274400,586600,192405,1.42543e+10,6.404e+09,-2.956e+06
20091102,862100,237700,624400,-1610,1.4253e+10,6.45986e+09,-5.78064e+06
20091103,860700,206100,654600,-89726,1.42367e+10,6.50053e+09,-7.43602e+06
20091104,861100,190600,670500,21608,1.424e+10,6.48954e+09,-8.46808e+06
20091105,860200,199300,660900,-177675,1.42074e+10,6.63787e+09,-7.90846e+06
20091106,857800,242700,615100,-14484,1.42065e+10,6.62656e+09,-5.73146e+06
20091109,853800,314900,538900,-63021,1.41934e+10,6.75879e+09,-459597
20091110,848900,421900,427000,59082,1.42052e+10,6.71166e+09,5.7599e+06
20091111,840500,540000,300500,37103,1.42109e+10,6.68621e+09,1.13666e+07
20091112,837600,597700,239900,-137064,1.4184e+10,6.58008e+09,1.45039e+07
20091113,835800,627900,207900,127599,1.42097e+10,6.60509e+09,1.65136e+07
20091116,834500,653800,180700,288228,1.42634e+10,6.69733e+09,1.80391e+07
20091117,832500,688100,144400,-15497,1.42606e+10,6.66692e+09,1.81836e+07
20091118,828000,733800,94200,-37507,1.42535e+10,6.60269e+09,1.9077e+07
20091119,828700,750400,78300,-294760,1.41944e+10,6.50443e+09,1.92706e+07
20091120,829300,761500,67800,-78829,1.41796e+10,6.49098e+09,1.91581e+07
20091123,830300,747000,83300,251151,1.42305e+10,6.58033e+09,1.85839e+07
20091124,831000,731900,99100,-21881,1.42279e+10,6.57902e+09,1.79696e+07
20091125,831800,719800,112000,98111,1.42459e+10,6.63097e+09,1.72469e+07
20091127,835100,700000,135100,-288673,1.41874e+10,6.53501e+09,1.62627e+07
20091130,835400,692900,142500,102890,1.42096e+10,6.56544e+09,1.59051e+07
20091201,836300,668400,167900,214809,1.42524e+10,6.66507e+09,1.49423e+07
20091202,836600,670800,165800,111076,1.42749e+10,6.6991e+09,1.52658e+07
20091203,838500,629700,208800,-65350,1.42622e+10,6.64246e+09,1.27863e+07
20091204,838100,637300,200800,143897,1.42915e+10,6.69401e+09,1.29419e+07
20091207,835400,638800,196600,-5272,1.4292e+10,6.65241e+09,1.2736e+07
20091208,835800,631100,204700,-92135,1.42733e+10,6.59773e+09,1.2022e+07
20091209,837900,604600,233300,29371,1.42786e+10,6.62214e+09,1.0857e+07
20091210,838100,627100,211000,69937,1.42968e+10,6.66099e+09,1.1383e+07
20091211,836900,625200,211700,84140,1.43141e+10,6.68645e+09,1.13707e+07
20091214,835900,648100,187800,101010,1.43349e+10,6.75717e+09,1.21888e+07
20091215,834200,673400,160800,-62111,1.43214e+10,6.71805e+09,1.41902e+07
20091216,832600,685800,146800,46246,1.43285e+10,6.7227e+09,1.58522e+07
20091217,835400,687400,148000,-153713,1.42984e+10,6.68087e+09,1.58746e+07
20091218,835300,687800,147500,83661,1.43136e+10,6.71483e+09,1.61787e+07
20091221,834900,689100,145800,161196,1.43416e+10,6.78317e+09,1.64617e+07
20091222,832000,687200,144800,130035,1.43682e+10,6.79233e+09,1.68147e+07
20091223,831300,693400,137900,111897,1.43899e+10,6.81781e+09,1.72727e+07
20091224,830100,705300,124800,110455,1.44121e+10,6.84487e+09,1.83224e+07
20091228,829800,703800,126000,-863,1.44144e+10,6.84389e+09,1.87819e+07
20091229,828800,708000,120800,-44505,1.44041e+10,6.82766e+09,1.91805e+07
20091230,828500,716300,112200,2931,1.44037e+10,6.82313e+09,1.96526e+07
20091231,828400,719700,108700,-223953,1.43608e+10,6.74877e+09,1.95446e+07
20100104,828200,728500,99700,268094,1.44135e+10,6.84141e+09,2.03996e+07
20100105,827800,740400,87400,67195,1.44267e+10,6.85111e+09,2.07006e+07
20100106,825200,746700,78500,23640,1.44307e+10,6.84228e+09,2.04254e+07
20100107,819100,760000,59100,122929,1.44501e+10,6.82951e+09,2.07235e+07
20100108,818600,755600,63000,85458,1.44695e+10,6.86056e+09,2.0509e+07
20100111,817500,736900,80600,35961,1.44786e+10,6.86888e+09,1.93365e+07
20100112,816800,718800,98000,-217385,1.44362e+10,6.79206e+09,1.77243e+07
20100113,816100,715200,100900,163143,1.44673e+10,6.85327e+09,1.74064e+07
20100114,814200,706800,107400,86620,1.44834e+10,6.85055e+09,1.7055e+07
20100115,808100,679800,128300,-178692,1.44495e+10,6.72431e+09,1.60721e+07
20100119,807900,672700,135200,206113,1.44871e+10,6.81168e+09,1.59029e+07
20100120,807800,671900,135900,-148490,1.44594e+10,6.73785e+09,1.5725e+07
20100121,807500,636800,170700,-191384,1.44216e+10,6.61955e+09,1.34609e+07
20100122,812700,544000,268700,-143637,1.43869e+10,6.54779e+09,8.37384e+06
20100125,815500,449600,365900,6876,1.43895e+10,6.60247e+09,4.12792e+06
20100126,816900,382100,434800,28905,1.43955e+10,6.58151e+09,-918842
20100127,816800,315900,500900,11103,1.4397e+10,6.60513e+09,-5.67514e+06
20100128,816300,271100,545200,182088,1.44307e+10,6.52072e+09,-8.18368e+06
20100129,816800,243800,573000,131660,1.446e+10,6.46007e+09,-9.77696e+06
20100201,816500,244200,572300,-198105,1.44215e+10,6.56866e+09,-9.9564e+06
20100202,815800,247300,568500,-142185,1.43946e+10,6.65219e+09,-9.99354e+06
20100203,812500,255600,556900,43183,1.44068e+10,6.56729e+09,-8.84206e+06
20100204,811000,244000,567000,344053,1.44778e+10,6.32876e+09,-8.89369e+06
20100205,811400,241100,570300,-21679,1.44705e+10,6.34768e+09,-8.78011e+06
20100208,811800,220400,591400,87198,1.44876e+10,6.30461e+09,-9.78676e+06
20100209,811200,192100,619100,-136394,1.44599e+10,6.38523e+09,-1.12468e+07
20100210,810900,161600,649300,44361,1.44716e+10,6.36523e+09,-1.30156e+07
20100211,811100,171300,639800,-98397,1.44538e+10,6.44849e+09,-1.22681e+07
20100212,807400,201300,606100,36773,1.44593e+10,6.42565e+09,-9.99192e+06
20100216,805000,292800,512200,-119504,1.44321e+10,6.53221e+09,-4.61945e+06
20100217,802400,416200,386200,29172,1.44367e+10,6.54685e+09,2.89126e+06
20100218,799400,546200,253200,79530,1.44535e+10,6.55826e+09,1.12604e+07
20100219,795000,601100,193900,59145,1.44642e+10,6.55666e+09,1.47348e+07
20100222,793400,673000,120400,-51120,1.44548e+10,6.53037e+09,1.72285e+07
20100223,793900,685800,108100,-214991,1.44147e+10,6.45421e+09,1.76128e+07
20100224,795700,707900,87800,200953,1.44557e+10,6.52633e+09,1.85824e+07
20100225,794900,708300,86600,11160,1.44574e+10,6.52579e+09,1.89176e+07
20100226,794900,707300,87600,35551,1.44645e+10,6.54154e+09,1.89557e+07
20100301,795100,704500,90600,255614,1.45121e+10,6.63927e+09,1.8986e+07
20100302,794100,714100,80000,85825,1.45292e+10,6.66107e+09,1.97367e+07
20100303,793500,726800,66700,-6691,1.45286e+10,6.65536e+09,2.0289e+07
20100304,792700,744500,48200,65412,1.45419e+10,6.66357e+09,2.09572e+07
20100305,792200,749700,42500,340383,1.46069e+10,6.76022e+09,2.16553e+07
20100308,791500,750100,41400,9745,1.46069e+10,6.76166e+09,2.17697e+07
20100309,791600,770200,21400,30601,1.46123e+10,6.7639e+09,2.25102e+07
20100310,791200,771600,19600,122817,1.46346e+10,6.79342e+09,2.2741e+07
20100311,791700,769800,21900,89690,1.46504e+10,6.82079e+09,2.28394e+07
20100312,791100,770500,20600,10837,1.46507e+10,6.82179e+09,2.28182e+07
20100315,793000,759500,33500,9293,1.46517e+10,6.84821e+09,2.24644e+07
20100316,792700,760300,32400,226295,1.46919e+10,6.91158e+09,2.25541e+07
20100317,792800,756600,36200,170088,1.47248e+10,6.95772e+09,2.24923e+07
20100318,792500,757900,34600,-38256,1.47212e+10,6.93906e+09,2.24466e+07
20100319,792700,756800,35900,-121415,1.46977e+10,6.90072e+09,2.22069e+07
20100322,792600,762000,30600,166515,1.47264e+10,6.95001e+09,2.26976e+07
20100323,791000,716400,74600,136697,1.47501e+10,6.97731e+09,2.21209e+07
20100324,791300,717800,73500,-132165,1.47269e+10,6.93764e+09,2.20028e+07
20100325,792300,711100,81200,-22188,1.4726e+10,6.92938e+09,2.14903e+07
20100326,792800,703300,89500,27619,1.47307e+10,6.93764e+09,2.09309e+07
20100329,792800,696400,96400,95739,1.47502e+10,6.98588e+09,2.05541e+07
20100330,792300,683900,108400,3065,1.47533e+10,6.98999e+09,1.98335e+07
20100331,792200,668200,124000,-95109,1.47358e+10,6.96355e+09,1.88878e+07
20100401,791600,665800,125800,133987,1.47558e+10,7.02147e+09,1.89911e+07
20100405,790400,709100,81300,229737,1.47941e+10,7.08938e+09,1.96989e+07
20100406,786900,722700,64200,84055,1.48106e+10,7.07842e+09,2.0601e+07
20100407,785400,719100,66300,-133833,1.47864e+10,7.01597e+09,2.05439e+07
20100408,783800,728400,55400,63797,1.47958e+10,7.03164e+09,2.12833e+07
20100409,782000,728100,53900,165803,1.48262e+10,7.07811e+09,2.13848e+07
20100412,780900,722700,58200,36982,1.48327e+10,7.07577e+09,2.10297e+07
20100413,779600,722800,56800,43150,1.48419e+10,7.08674e+09,2.10248e+07
20100414,776300,723000,53300,297283,1.48961e+10,7.13178e+09,2.11384e+07
20100415,773900,720300,53600,9404,1.48983e+10,7.10763e+09,2.11775e+07
20100416,771200,706400,64800,-320500,1.48375e+10,6.96716e+09,2.0174e+07
20100419,770800,701600,69200,50535,1.48479e+10,6.97974e+09,2.01983e+07
20100420,769000,709600,59400,276219,1.48994e+10,7.04015e+09,2.04331e+07
20100421,768800,701400,67400,95817,1.49178e+10,7.04826e+09,2.00132e+07
20100422,766400,696000,70400,233738,1.49594e+10,7.10265e+09,1.99676e+07
20100423,765700,694500,71200,198182,1.49958e+10,7.1616e+09,2.00065e+07
20100426,764100,692100,72000,-25881,1.4989e+10,7.13648e+09,1.97831e+07
20100427,764000,673600,90400,-515237,1.4897e+10,6.96227e+09,1.85192e+07
20100428,763700,665200,98500,66537,1.49097e+10,6.98924e+09,1.79761e+07
20100429,763200,649700,113500,315655,1.49686e+10,7.10831e+09,1.74377e+07
20100430,759100,605700,153400,-301429,1.4913e+10,6.926e+09,1.58839e+07
20100503,757000,585400,171600,305690,1.49674e+10,7.01561e+09,1.46163e+07
20100504,757600,555000,202600,-346861,1.49094e+10,6.85354e+09,1.25409e+07
20100505,758100,468000,290100,-142701,1.48851e+10,6.79587e+09,9.82393e+06
20100506,755500,360900,394600,-55693,1.48794e+10,6.58358e+09,2.1995e+06
20100507,754700,250500,504200,87035,1.48954e+10,6.45367e+09,-5.11608e+06
20100510,754500,179600,574900,-493776,1.48099e+10,6.78197e+09,-1.06071e+07
20100511,752600,138100,614500,59264,1.4821e+10,6.75262e+09,-1.22783e+07
20100512,752100,140200,611900,-214207,1.47824e+10,6.87325e+09,-1.23649e+07
20100513,750800,161300,589500,144351,1.48082e+10,6.77311e+09,-1.05283e+07
20100514,750100,238200,511900,122636,1.48319e+10,6.61591e+09,-5.13222e+06
20100517,750600,237100,513500,4368,1.48329e+10,6.6341e+09,-4.87024e+06
20100518,750100,210300,539800,116855,1.4857e+10,6.51892e+09,-6.11675e+06
20100519,747900,160000,587900,79447,1.48683e+10,6.4378e+09,-9.53628e+06
20100520,750100,119000,631100,605737,1.49799e+10,6.20274e+09,-1.28463e+07
20100521,751100,91000,660100,-293490,1.49283e+10,6.3271e+09,-1.478e+07
20100524,752100,70000,682100,264380,1.49782e+10,6.26057e+09,-1.64207e+07
20100525,756300,51000,705300,-13947,1.49783e+10,6.31077e+09,-1.76953e+07
20100526,756500,44300,712200,26539,1.49844e+10,6.30045e+09,-1.83917e+07
20100527,756100,50200,705900,-669410,1.48604e+10,6.52276e+09,-1.84992e+07
20100528,755600,60000,695600,208515,1.48942e+10,6.42375e+09,-1.7538e+07
20100601,755700,91300,664400,401101,1.49701e+10,6.2931e+09,-1.55758e+07
20100602,754600,147900,606700,-799875,1.47795e+10,6.45441e+09,-1.29047e+07
20100603,752900,256300,496600,7491,1.47805e+10,6.47524e+09,-6.09863e+06
20100604,753200,257200,496000,282613,1.48409e+10,6.22532e+09,-5.73928e+06
20100607,760000,200400,559600,186458,1.4875e+10,6.19444e+09,-8.27858e+06
20100608,760800,200200,560600,-116657,1.48525e+10,6.25334e+09,-8.16373e+06
20100609,763200,168400,594800,24982,1.48565e+10,6.25611e+09,-9.65242e+06
20100610,763100,162500,600600,-400517,1.47781e+10,6.45902e+09,-1.02917e+07
20100611,763300,218000,545300,-36479,1.47701e+10,6.50272e+09,-6.56915e+06
20100614,761700,343200,418500,42616,1.47817e+10,6.49032e+09,967670
20100615,756300,506100,250200,214811,1.4821e+10,6.57828e+09,9.99325e+06
20100616,754600,592900,161700,4114,1.48234e+10,6.54885e+09,1.54921e+07
20100617,756400,637800,118600,49602,1.48348e+10,6.56727e+09,1.79625e+07
20100618,757300,650200,107100,-9314,1.48324e+10,6.58498e+09,1.8736e+07
20100621,758400,665100,93300,-92803,1.48147e+10,6.57867e+09,1.94841e+07
20100622,758900,660900,98000,-391457,1.47441e+10,6.43989e+09,1.88593e+07
20100623,761700,639900,121800,-34803,1.47366e+10,6.45563e+09,1.75723e+07
20100624,768200,586800,181400,-186279,1.46991e+10,6.37936e+09,1.39825e+07
20100625,769800,563600,206200,96868,1.47184e+10,6.44377e+09,1.2609e+07
20100628,776700,486900,289800,5677,1.47213e+10,6.45881e+09,8.07332e+06
20100629,790000,357100,432900,101481,1.4737e+10,6.34637e+09,-164767
20100630,799200,265200,534000,90420,1.47516e+10,6.3422e+09,-6.55425e+06
20100701,805600,189900,615700,30903,1.47565e+10,6.37837e+09,-1.03852e+07
20100702,810300,129700,680600,150545,1.47843e+10,6.37624e+09,-1.42901e+07
20100706,812300,93100,719200,-9423,1.47834e+10,6.40602e+09,-1.65085e+07
20100707,812000,90600,721400,-606963,1.46748e+10,6.62217e+09,-1.72362e+07
20100708,811900,97200,714700,-146640,1.46486e+10,6.67881e+09,-1.67549e+07
20100709,811300,152000,659300,-159916,1.46193e+10,6.72566e+09,-1.40717e+07
20100712,810400,243900,566500,40446,1.46303e+10,6.70006e+09,-7.87796e+06
20100713,803300,446000,357300,-4911,1.46309e+10,6.75284e+09,3.48374e+06
20100714,797300,535200,262100,-25115,1.46284e+10,6.6965e+09,8.87388e+06
20100715,791500,615600,175900,37125,1.4637e+10,6.65505e+09,1.27174e+07
20100716,759100,616000,143100,-401928,1.45641e+10,6.09183e+09,1.35504e+07
20100719,759300,638700,120600,118664,1.45845e+10,6.1258e+09,1.4736e+07
20100720,760500,626300,134200,166018,1.46224e+10,6.20858e+09,1.48862e+07
20100721,764700,592600,172100,-172550,1.45893e+10,6.14354e+09,1.32679e+07
20100722,763500,594300,169200,319713,1.46541e+10,6.27195e+09,1.3683e+07
20100723,762200,618900,143300,180497,1.46872e+10,6.35629e+09,1.58253e+07
20100726,759800,651700,108100,223955,1.47312e+10,6.4158e+09,1.78237e+07
20100727,758700,670800,87900,-93899,1.47156e+10,6.35687e+09,1.86639e+07
20100728,756600,682800,73800,-145446,1.46874e+10,6.29996e+09,1.90117e+07
20100729,759000,681000,78000,-56530,1.46769e+10,6.28754e+09,1.89528e+07
20100730,762000,674900,87100,54828,1.46884e+10,6.32415e+09,1.86872e+07
20100802,761600,663100,98500,403756,1.47678e+10,6.44719e+09,1.8159e+07
20100803,762100,651300,110800,-140854,1.47414e+10,6.41172e+09,1.74254e+07
20100804,761500,644800,116700,132190,1.47682e+10,6.46842e+09,1.75565e+07
20100805,762400,643000,119400,-6300,1.4768e+10,6.45704e+09,1.7458e+07
20100806,762200,658600,103600,-74186,1.47529e+10,6.44267e+09,1.80174e+07
20100809,762500,654500,108000,163044,1.47845e+10,6.49377e+09,1.82083e+07
20100810,761700,657000,104700,-128834,1.47577e+10,6.4422e+09,1.83057e+07
20100811,764800,623200,141600,-530381,1.46549e+10,6.2769e+09,1.62168e+07
20100812,767500,590700,176800,-63104,1.46414e+10,6.27963e+09,1.4866e+07
20100813,772700,497500,275200,-43524,1.46347e+10,6.28428e+09,1.03297e+07
20100816,778800,349300,429500,31507,1.46411e+10,6.33771e+09,2.34736e+06
20100817,778500,280800,497700,-33539,1.46374e+10,6.43916e+09,-1.92533e+06
20100818,778100,264800,513300,-46693,1.46278e+10,6.44031e+09,-2.32908e+06
20100819,780700,266100,514600,110739,1.46455e+10,6.32521e+09,-3.13411e+06
20100820,781100,268400,512700,84758,1.46632e+10,6.32582e+09,-3.15734e+06
20100823,781200,275900,505300,64287,1.46749e+10,6.29519e+09,-2.85891e+06
20100824,781500,245300,536200,190301,1.47075e+10,6.19708e+09,-5.48544e+06
20100825,782100,205800,576300,-44433,1.47012e+10,6.22947e+09,-8.38681e+06
20100826,782300,178000,604300,92665,1.47159e+10,6.18937e+09,-9.51085e+06
20100827,782800,170400,612400,-249722,1.46711e+10,6.3105e+09,-1.0102e+07
20100830,782700,163300,619400,217383,1.47096e+10,6.20447e+09,-1.04901e+07
20100831,782700,173300,609400,44696,1.47182e+10,6.20135e+09,-9.83221e+06
20100901,782400,220500,561900,-312509,1.46596e+10,6.39806e+09,-7.12941e+06
20100902,779300,323200,456100,-74456,1.4649e+10,6.44457e+09,-1.0815e+06
20100903,773100,450600,322500,2255,1.46574e+10,6.44911e+09,5.90843e+06
20100907,769900,565900,204000,-121804,1.46337e+10,6.33918e+09,1.23926e+07
20100908,764100,678300,85800,148762,1.46612e+10,6.32505e+09,1.85993e+07
20100909,764800,697000,67800,60569,1.46726e+10,6.3355e+09,1.99203e+07
20100910,764700,701900,62800,105356,1.46939e+10,6.37356e+09,2.02245e+07
20100913,764500,701400,63100,290973,1.47457e+10,6.44427e+09,2.05304e+07
20100914,764300,716600,47700,-13108,1.4744e+10,6.45027e+09,2.13073e+07
20100915,763500,729700,33800,56647,1.47569e+10,6.46901e+09,2.17834e+07
20100916,763100,729600,33500,-53554,1.4747e+10,6.45048e+09,2.18421e+07
20100917,765400,747100,18300,41158,1.47556e+10,6.48733e+09,2.21322e+07
20100920,765300,747500,17800,377499,1.4829e+10,6.5987e+09,2.25065e+07
20100921,764900,750900,14000,-101506,1.48113e+10,6.56531e+09,2.27768e+07
20100922,765500,753000,12500,-163320,1.47802e+10,6.52988e+09,2.27566e+07
20100923,765200,752700,12500,-190677,1.47465e+10,6.46421e+09,2.25751e+07
20100924,765400,743100,22300,552003,1.48508e+10,6.61977e+09,2.25384e+07
20100927,765700,734400,31300,-101535,1.48329e+10,6.57823e+09,2.19629e+07
20100928,765700,718000,47700,156674,1.4864e+10,6.61569e+09,2.11606e+07
20100929,765000,712200,52800,-30276,1.48576e+10,6.60306e+09,2.06434e+07
20100930,764700,708000,56700,-60639,1.48455e+10,6.58053e+09,2.02128e+07
20101001,764400,692500,71900,49353,1.48567e+10,6.59633e+09,2.0139e+07
20101004,764200,686600,77600,-150310,1.48256e+10,6.55186e+09,1.9632e+07
20101005,762300,684300,78000,419566,1.4907e+10,6.67929e+09,1.96453e+07
20101006,761500,688200,73300,-71627,1.48941e+10,6.6398e+09,1.99343e+07
20101007,760800,704900,55900,-36795,1.48892e+10,6.61706e+09,2.02631e+07
20101008,759900,708200,51700,156991,1.49189e+10,6.65968e+09,2.08981e+07
20101011,758100,708200,49900,37881,1.49251e+10,6.64735e+09,2.15573e+07
20101012,757600,711000,46600,32111,1.49303e+10,6.66513e+09,2.17085e+07
20101013,756400,705300,51100,176106,1.49621e+10,6.71973e+09,2.18609e+07
20101014,756000,702100,53900,-98208,1.4945e+10,6.68821e+09,2.16129e+07
20101015,755100,695900,59200,59048,1.49564e+10,6.70486e+09,2.15183e+07
20101018,755400,688100,67300,131386,1.49845e+10,6.74683e+09,2.1493e+07
20101019,755000,675800,79200,-330429,1.49231e+10,6.63702e+09,2.04137e+07
20101020,755200,663400,91800,251874,1.49727e+10,6.70647e+09,2.01681e+07
20101021,754300,641700,112600,26631,1.49789e+10,6.71629e+09,1.96971e+07
20101022,754200,636800,117400,62599,1.49909e+10,6.74286e+09,1.93928e+07
20101025,753300,618500,134800,78550,1.5007e+10,6.76702e+09,1.81362e+07
20101026,751800,610200,141600,3872,1.50038e+10,6.75627e+09,1.80495e+07
20101027,751300,609400,141900,-44751,1.49979e+10,6.72585e+09,1.80158e+07
20101028,750000,609800,140200,-20425,1.49945e+10,6.70553e+09,1.79556e+07
20101029,750800,592300,158500,64170,1.50038e+10,6.73793e+09,1.6809e+07
20101101,749600,566500,183100,6755,1.5004e+10,6.72275e+09,1.52071e+07
20101102,748100,571900,176200,138222,1.50284e+10,6.77694e+09,1.50612e+07
20101103,747200,568400,178800,54200,1.50387e+10,6.78147e+09,1.49567e+07
20101104,742500,585200,157300,319250,1.50968e+10,6.86566e+09,1.67551e+07
20101105,736800,614300,122500,107456,1.51147e+10,6.83709e+09,1.80935e+07
20101108,731200,634200,97000,-48580,1.51043e+10,6.76953e+09,1.89911e+07
20101109,730300,628200,102100,-195893,1.50675e+10,6.69374e+09,1.83935e+07
20101110,728700,628800,99900,113547,1.50913e+10,6.72222e+09,1.84574e+07
20101111,728500,614000,114500,-12926,1.5089e+10,6.71416e+09,1.77166e+07
20101112,727900,593100,134800,-209976,1.50499e+10,6.62244e+09,1.64128e+07
20101115,727800,574300,153500,-24303,1.50447e+10,6.61159e+09,1.56769e+07
20101116,726800,537200,189600,-248317,1.49963e+10,6.49787e+09,1.32261e+07
20101117,728600,497000,231600,46862,1.50039e+10,6.53537e+09,1.06483e+07
20101118,728200,461900,266300,131057,1.50289e+10,6.63713e+09,8.8503e+06
20101119,728800,453600,275200,78842,1.50459e+10,6.6838e+09,8.0882e+06
20101122,728300,436700,291600,19577,1.50511e+10,6.70153e+09,7.52231e+06
20101123,728700,441100,287600,-98675,1.50329e+10,6.61672e+09,8.26451e+06
20101124,728600,471100,257500,209213,1.50739e+10,6.73367e+09,1.04309e+07
20101126,729400,438300,291100,-39783,1.50687e+10,6.70253e+09,9.11012e+06
20101129,729900,416900,313000,-47817,1.50596e+10,6.69062e+09,8.23847e+06
20101130,730100,405600,324500,1019,1.50583e+10,6.67271e+09,7.39131e+06
20101201,727800,417300,310500,192520,1.50976e+10,6.79904e+09,8.30688e+06
20101202,725000,443900,281100,96216,1.51172e+10,6.84277e+09,1.00624e+07
20101203,719600,513900,205700,27712,1.51228e+10,6.80289e+09,1.38038e+07
20101206,712900,576100,136800,-9812,1.51208e+10,6.73248e+09,1.71401e+07
20101207,704500,632400,72100,13776,1.51234e+10,6.6437e+09,1.94759e+07
20101208,703300,646800,56500,32985,1.51273e+10,6.63294e+09,2.05921e+07
20101209,702100,656100,46000,76443,1.51405e+10,6.63604e+09,2.10953e+07
20101210,701900,670500,31400,130235,1.51645e+10,6.66115e+09,2.21659e+07
20101213,701300,676000,25300,-28722,1.516e+10,6.64368e+09,2.2308e+07
20101214,700400,667500,32900,23860,1.51685e+10,6.62768e+09,2.18345e+07
20101215,699700,661100,38600,-106102,1.51499e+10,6.58584e+09,2.1094e+07
20101216,699300,656500,42800,172345,1.51856e+10,6.63228e+09,2.06895e+07
20101217,698600,649600,49000,52827,1.51977e+10,6.63469e+09,2.01208e+07
20101220,698500,645000,53500,48537,1.52068e+10,6.65188e+09,1.95756e+07
20101221,698400,649400,49000,123594,1.52319e+10,6.69193e+09,1.99588e+07
20101222,698500,651000,47500,41928,1.52342e+10,6.69789e+09,2.02637e+07
20101223,698000,651700,46300,-68047,1.52227e+10,6.67494e+09,2.01838e+07
20101227,695800,642600,53200,30852,1.52296e+10,6.65974e+09,2.01317e+07
20101228,695700,643100,52600,-16708,1.52258e+10,6.65405e+09,2.02399e+07
20101229,697500,633300,64200,38193,1.52332e+10,6.68803e+09,1.97418e+07
20101230,697100,626100,71000,-13926,1.52322e+10,6.67272e+09,1.95823e+07
20101231,697200,621400,75800,-17674,1.52285e+10,6.66175e+09,1.94518e+07
20110103,697200,633200,64000,215658,1.52672e+10,6.73223e+09,2.02801e+07
20110104,696700,633600,63100,121359,1.52798e+10,6.70203e+09,1.99941e+07
20110105,694400,628600,65800,101996,1.52984e+10,6.71405e+09,1.93799e+07
20110106,693300,618900,74400,-20596,1.52934e+10,6.68071e+09,1.85898e+07
20110107,692000,614200,77800,-5558,1.52903e+10,6.66014e+09,1.80543e+07
20110110,691000,606100,84900,-34688,1.52857e+10,6.66089e+09,1.71002e+07
20110111,689700,580000,109700,93818,1.53052e+10,6.67632e+09,1.58001e+07
20110112,689100,576100,113000,158656,1.53346e+10,6.72316e+09,1.55967e+07
20110113,689200,570500,118700,-4615,1.53324e+10,6.71975e+09,1.52276e+07
20110114,687300,566000,121300,145224,1.53602e+10,6.75217e+09,1.54483e+07
20110118,686700,575100,111600,74942,1.53752e+10,6.77366e+09,1.6129e+07
20110119,686800,574900,111900,-261306,1.53268e+10,6.68513e+09,1.63343e+07
20110120,685600,568100,117500,-48546,1.53167e+10,6.64306e+09,1.58954e+07
20110121,685500,562700,122800,55880,1.53269e+10,6.66273e+09,1.53384e+07
20110124,684200,548600,135600,112488,1.53461e+10,6.69862e+09,1.49541e+07
20110125,682400,524300,158100,43345,1.53529e+10,6.68465e+09,1.37544e+07
20110126,682100,526600,155500,60155,1.53617e+10,6.72873e+09,1.46599e+07
20110127,679900,535500,144400,60795,1.53699e+10,6.75546e+09,1.53738e+07
20110128,678500,516600,161900,-274251,1.53178e+10,6.63451e+09,1.44646e+07
20110131,676400,509300,167100,115447,1.53418e+10,6.67558e+09,1.40268e+07
20110201,674100,503500,170600,228746,1.53818e+10,6.74219e+09,1.40486e+07
20110202,672200,495800,176400,18448,1.53912e+10,6.68421e+09,1.38334e+07
20110203,669800,495900,173900,46022,1.53982e+10,6.68634e+09,1.36988e+07
20110204,664600,504500,160100,89230,1.54123e+10,6.68122e+09,1.45697e+07
20110207,656000,525900,130100,81133,1.54265e+10,6.65006e+09,1.57574e+07
20110208,654800,541400,113400,57336,1.54333e+10,6.6668e+09,1.71468e+07
20110209,653500,553700,99800,-49729,1.54238e+10,6.64485e+09,1.82964e+07
20110210,651100,555800,95300,80391,1.54407e+10,6.64059e+09,1.86489e+07
20110211,651000,560300,90700,150942,1.547e+10,6.69041e+09,1.91804e+07
20110214,649200,565400,83800,22964,1.54765e+10,6.68584e+09,1.94767e+07
20110215,648300,573200,75100,-94524,1.54568e+10,6.63769e+09,1.93597e+07
20110216,648600,575100,73500,99329,1.5472e+10,6.67843e+09,1.968e+07
20110217,648100,587500,60600,63290,1.54852e+10,6.68921e+09,2.02135e+07
20110218,647600,587300,60300,44444,1.54919e+10,6.69452e+09,2.02258e+07
20110222,648300,578500,69800,-482647,1.53973e+10,6.55203e+09,1.90421e+07
20110223,649600,541600,108000,-163194,1.53668e+10,6.50838e+09,1.69904e+07
20110224,651600,522000,129600,25156,1.53734e+10,6.5367e+09,1.56244e+07
20110225,651600,478600,173000,195838,1.54088e+10,6.62967e+09,1.33265e+07
20110228,652200,413200,239000,86970,1.54274e+10,6.66693e+09,9.87202e+06
20110301,650500,376000,274500,-64196,1.5417e+10,6.52398e+09,6.9659e+06
20110302,650900,374900,276000,-17598,1.54165e+10,6.52795e+09,7.07087e+06
20110303,650300,385200,265100,153102,1.54478e+10,6.64287e+09,7.94579e+06
20110304,647900,382700,265200,2094,1.54456e+10,6.5943e+09,7.94749e+06
20110307,647500,366400,281100,-56592,1.54372e+10,6.53247e+09,6.79699e+06
20110308,646600,370800,275800,12237,1.54441e+10,6.58131e+09,7.81622e+06
20110309,646700,402900,243800,6219,1.54466e+10,6.56224e+09,9.03443e+06
20110310,647300,394900,252400,-124056,1.54198e+10,6.46583e+09,8.03658e+06
20110311,646500,376100,270400,25990,1.54278e+10,6.52964e+09,6.27637e+06
20110314,645900,390500,255400,-64904,1.5419e+10,6.47146e+09,6.29225e+06
20110315,646200,364000,282200,-60124,1.54069e+10,6.42264e+09,4.2841e+06
20110316,648400,325100,323300,17757,1.54122e+10,6.34695e+09,584144
20110317,650400,275100,375300,-67257,1.53981e+10,6.44348e+09,-2.19182e+06
20110318,651100,253800,397300,198,1.53979e+10,6.46762e+09,-3.8501e+06
20110321,650800,239400,411400,-68306,1.53843e+10,6.57052e+09,-4.49043e+06
20110322,651400,261200,390200,31285,1.53904e+10,6.5404e+09,-2.96679e+06
20110323,649600,295800,353800,-3172,1.53918e+10,6.53463e+09,-81863
20110324,648600,356500,292100,50085,1.54016e+10,6.59243e+09,4.74205e+06
20110325,645500,399600,245900,61588,1.54128e+10,6.60014e+09,8.17726e+06
20110328,644200,428600,215600,-27122,1.54079e+10,6.57319e+09,1.08202e+07
20110329,643200,476500,166700,119415,1.54304e+10,6.62113e+09,1.41115e+07
20110330,642600,513400,129200,116838,1.54514e+10,6.66976e+09,1.64821e+07
20110331,641000,542400,98600,-8567,1.5453e+10,6.65035e+09,1.87097e+07
20110401,638900,560900,78000,142953,1.54815e+10,6.65857e+09,1.95741e+07
20110404,637400,573100,64300,12479,1.54846e+10,6.64697e+09,2.06003e+07
20110405,636400,585200,51200,-1921,1.54836e+10,6.63352e+09,2.042e+07
20110406,635800,587900,47900,22914,1.54885e+10,6.63036e+09,2.05371e+07
20110407,635600,584200,51400,-55131,1.54801e+10,6.6121e+09,2.04743e+07
20110408,636300,578400,57900,-105094,1.54612e+10,6.5774e+09,2.01402e+07
20110411,637000,581700,55300,-60635,1.54461e+10,6.57586e+09,2.01942e+07
20110412,637700,577800,59900,-131023,1.54176e+10,6.53662e+09,1.93366e+07
20110413,638800,556400,82400,13634,1.54223e+10,6.56184e+09,1.78468e+07
20110414,641300,523000,118300,22280,1.54263e+10,6.58787e+09,1.52854e+07
20110415,641600,492900,148700,108247,1.54473e+10,6.63367e+09,1.31101e+07
20110418,643200,463300,179900,-97284,1.54312e+10,6.5744e+09,1.15704e+07
20110419,643800,444100,199700,24690,1.54349e+10,6.61891e+09,1.01842e+07
20110420,644300,438500,205800,135662,1.54579e+10,6.72905e+09,1.00984e+07
20110421,643700,436400,207300,56252,1.54707e+10,6.75552e+09,1.0157e+07
20110425,642500,444300,198200,5123,1.54714e+10,6.71647e+09,1.08907e+07
20110426,640600,495100,145500,112526,1.54911e+10,6.74958e+09,1.45082e+07
20110427,638900,518400,120500,130291,1.55163e+10,6.77127e+09,1.57807e+07
20110428,636400,537000,99400,54309,1.55261e+10,6.75673e+09,1.689e+07
20110429,633700,545900,87800,12015,1.55334e+10,6.72007e+09,1.7782e+07
20110502,632400,552400,80000,-22369,1.55302e+10,6.69369e+09,1.81768e+07
20110503,632000,566100,65900,-84160,1.55163e+10,6.63901e+09,1.82099e+07
20110504,632200,564700,67500,-102424,1.54966e+10,6.58062e+09,1.77515e+07
20110505,632100,543800,88300,-77304,1.54826e+10,6.53957e+09,1.62474e+07
20110506,632600,528100,104500,68910,1.54966e+10,6.5789e+09,1.4785e+07
20110509,633700,509800,123900,581683,1.56677e+10,6.63899e+09,1.42043e+07
20110510,633400,506900,126500,129378,1.56952e+10,6.70327e+09,1.40755e+07
20110511,633300,504600,128700,-73382,1.56769e+10,6.6351e+09,1.38798e+07
20110512,620800,491600,129200,138632,1.57031e+10,6.47091e+09,1.43591e+07
20110513,621500,476300,145200,-108761,1.56823e+10,6.43594e+09,1.387e+07
20110516,621400,450800,170600,-28487,1.56762e+10,6.40691e+09,1.2629e+07
20110517,622800,424000,198800,27157,1.56842e+10,6.41229e+09,1.00457e+07
20110518,623500,404700,218800,55657,1.56979e+10,6.49716e+09,9.62524e+06
20110519,622900,387700,235200,41719,1.57055e+10,6.50943e+09,8.68072e+06
20110520,623900,382200,241700,-32968,1.56997e+10,6.47629e+09,8.04712e+06
20110523,624900,366600,258300,-111991,1.5672e+10,6.39874e+09,7.09207e+06
20110524,625100,363000,262100,-43894,1.56644e+10,6.40315e+09,6.71254e+06
20110525,625500,332300,293200,-21054,1.56565e+10,6.42685e+09,5.14303e+06
20110526,625300,299100,326200,14010,1.56591e+10,6.46732e+09,2.98159e+06
20110527,625700,309000,316700,-8635,1.56582e+10,6.50187e+09,3.50611e+06
20110531,624200,329900,294300,28397,1.56631e+10,6.55365e+09,5.06753e+06
20110601,623900,342400,281500,-47824,1.56534e+10,6.39521e+09,5.60783e+06
20110602,623800,342400,281400,-7535,1.56513e+10,6.39343e+09,5.69957e+06
20110603,626100,325900,300200,5479,1.56485e+10,6.34649e+09,4.27943e+06
20110606,628000,277600,350400,-14218,1.56466e+10,6.29365e+09,443192
20110607,629900,204700,425200,561,1.56483e+10,6.32168e+09,-5.26884e+06
20110608,633800,144700,489100,93552,1.56666e+10,6.30947e+09,-8.62027e+06
20110609,634000,129500,504500,-66858,1.56529e+10,6.3554e+09,-1.02134e+07
20110610,634700,105900,528800,181114,1.56861e+10,6.2633e+09,-1.22095e+07
20110613,634800,112400,522400,-13608,1.56826e+10,6.26573e+09,-1.2181e+07
20110614,634900,104700,530200,-205444,1.56455e+10,6.36427e+09,-1.3196e+07
20110615,635200,93800,541400,261985,1.5694e+10,6.25965e+09,-1.36647e+07
20110616,635700,89400,546300,17544,1.57018e+10,6.2563e+09,-1.41198e+07
20110617,635900,115800,520100,-56782,1.5693e+10,6.28274e+09,-1.2595e+07
20110620,635800,188800,447000,-18618,1.56904e+10,6.33392e+09,-8.39081e+06
20110621,635600,214600,421000,-159277,1.56582e+10,6.42482e+09,-6.25864e+06
20110622,634700,287200,347500,34416,1.56656e+10,6.38136e+09,-1.1691e+06
20110623,634300,345900,288400,-13376,1.56605e+10,6.37102e+09,3.17724e+06
20110624,633100,376900,256200,645,1.56634e+10,6.29941e+09,5.28382e+06
20110627,632100,411100,221000,22705,1.56634e+10,6.33199e+09,7.94571e+06
20110628,631900,440700,191200,150510,1.5692e+10,6.41818e+09,1.01761e+07
20110629,631000,491900,139100,68462,1.57007e+10,6.47433e+09,1.33575e+07
20110630,631600,540200,91400,152229,1.573e+10,6.54905e+09,1.72062e+07
20110701,629000,588300,40700,307799,1.57896e+10,6.62484e+09,2.04334e+07
20110705,631800,598400,33400,-56775,1.57829e+10,6.66363e+09,2.16211e+07
20110706,632100,608900,23200,24975,1.57893e+10,6.67441e+09,2.25859e+07
20110707,632000,610900,21100,241577,1.58342e+10,6.73805e+09,2.2924e+07
20110708,631900,613100,18800,-191028,1.57985e+10,6.69056e+09,2.28496e+07
20110711,632000,612500,19500,-464536,1.57105e+10,6.55993e+09,2.2386e+07
20110712,633100,601600,31500,-85320,1.56934e+10,6.54251e+09,2.18371e+07
20110713,634900,577600,57300,36234,1.56994e+10,6.58571e+09,2.09466e+07
20110714,640100,514300,125800,-144873,1.56729e+10,6.57312e+09,1.80925e+07
20110715,644400,437700,206700,105729,1.56929e+10,6.66201e+09,1.36363e+07
20110718,647300,391800,255500,-61357,1.56812e+10,6.62658e+09,1.0374e+07
20110719,648300,367000,281300,178899,1.57159e+10,6.75346e+09,8.51087e+06
20110720,649000,341300,307700,-49290,1.57071e+10,6.75134e+09,7.15628e+06
20110721,649000,346200,302800,24254,1.57155e+10,6.8249e+09,7.27502e+06
20110722,647300,388700,258600,20883,1.57166e+10,6.82705e+09,8.42035e+06
20110725,648500,400900,247600,-14656,1.57167e+10,6.79622e+09,8.90496e+06
20110726,647400,399700,247700,-39196,1.57094e+10,6.7387e+09,8.515e+06
20110727,650700,377600,273100,-49589,1.56982e+10,6.61337e+09,5.86004e+06
20110728,653300,343700,309600,77118,1.57146e+10,6.61718e+09,3.1938e+06
20110729,654600,300500,354100,-36001,1.57081e+10,6.60458e+09,-754997
20110801,655600,268700,386900,85544,1.57245e+10,6.56942e+09,-3.44388e+06
20110802,662100,175600,486500,330472,1.57837e+10,6.4433e+09,-9.26932e+06
20110803,664100,145300,518800,-98314,1.57656e+10,6.51242e+09,-1.13762e+07
20110804,671600,65100,606500,865455,1.59221e+10,6.24766e+09,-1.5865e+07
20110805,674800,27100,647700,47467,1.59304e+10,6.27269e+09,-1.86107e+07
20110808,677300,2700,674600,1.54675e+06,1.62286e+10,5.85076e+09,-1.96363e+07
20110809,677400,1700,675700,-1.0465e+06,1.60274e+10,6.16986e+09,-2.09368e+07
20110810,677500,200,677300,873018,1.61959e+10,5.92607e+09,-2.01825e+07
20110811,677500,200,677300,-1.0108e+06,1.59993e+10,6.22025e+09,-2.11933e+07
20110812,677500,200,677300,-123728,1.59744e+10,6.27135e+09,-2.13171e+07
20110815,677400,4300,673100,-463722,1.58863e+10,6.3968e+09,-2.11485e+07
20110816,676700,22000,654700,226011,1.59291e+10,6.31833e+09,-1.92782e+07
20110817,676200,72000,604200,49711,1.59378e+10,6.28429e+09,-1.53249e+07
20110818,675900,96100,579800,841534,1.6099e+10,5.96732e+09,-1.31586e+07
20110819,675600,119500,556100,249401,1.61443e+10,5.87187e+09,-1.12556e+07
20110822,677300,120500,556800,-4079,1.61449e+10,5.90844e+09,-1.13766e+07
20110823,677200,122700,554500,-496427,1.60496e+10,6.13788e+09,-1.15353e+07
20110824,676700,130700,546000,-204768,1.60109e+10,6.22387e+09,-1.10743e+07
20110825,676800,171900,504900,172210,1.60405e+10,6.10834e+09,-7.97464e+06
20110826,677100,236600,440500,-147008,1.60171e+10,6.23099e+09,-3.36988e+06
20110829,678000,365100,312900,66528,1.6031e+10,6.42669e+09,6.27055e+06
20110830,683500,486300,197200,61767,1.60433e+10,6.52135e+09,1.29791e+07
20110831,695000,594400,100600,90112,1.60619e+10,6.64898e+09,1.76955e+07
20110901,710000,682300,27700,-306695,1.60031e+10,6.67108e+09,2.1155e+07
20110902,716200,695100,21100,-587112,1.589e+10,6.52028e+09,2.10999e+07
20110906,724600,669600,55000,-108705,1.58673e+10,6.57612e+09,2.00048e+07
20110907,728300,642800,85500,585215,1.5979e+10,6.81945e+09,1.96142e+07
20110908,734300,580900,153400,-160982,1.59466e+10,6.8131e+09,1.68112e+07
20110909,744400,515200,229200,-351032,1.58851e+10,6.73045e+09,1.27086e+07
20110912,747100,490600,256500,107724,1.59032e+10,6.7973e+09,1.1179e+07
20110913,747600,511900,235700,148122,1.59319e+10,6.88698e+09,1.18491e+07
20110914,747200,507000,240200,163471,1.59641e+10,6.98315e+09,1.12026e+07
20110915,746000,537200,208800,190112,1.59986e+10,7.06254e+09,1.22994e+07
20110916,744500,585500,159000,122798,1.60192e+10,7.08092e+09,1.53123e+07
20110919,744000,606600,137400,-129132,1.59952e+10,7.01132e+09,1.59944e+07
20110920,744500,599600,144900,-15348,1.59967e+10,6.97698e+09,1.60813e+07
20110921,748900,564200,184700,-384537,1.59274e+10,6.813e+09,1.40141e+07
20110922,762100,455700,306400,-131583,1.5908e+10,6.68781e+09,7.62198e+06
20110923,774600,328700,445900,52026,1.59157e+10,6.84896e+09,118382
20110926,776000,287000,489000,-175080,1.58856e+10,7.00238e+09,-2.79925e+06
20110927,776400,245800,530600,-167072,1.58573e+10,7.0947e+09,-5.53778e+06
20110928,777000,242400,534600,290873,1.59127e+10,6.92494e+09,-5.71834e+06
20110929,777500,261200,516300,-107380,1.58884e+10,6.94173e+09,-4.63324e+06
20110930,778600,294400,484200,246919,1.59353e+10,6.75928e+09,-2.52463e+06
20111003,783200,254000,529200,285445,1.59932e+10,6.59941e+09,-5.13131e+06
20111004,785900,208700,577200,-358095,1.59279e+10,6.80524e+09,-8.05796e+06
20111005,786100,208100,578000,-277703,1.58719e+10,6.92843e+09,-8.54981e+06
20111006,785600,221900,563700,-274636,1.58191e+10,7.08226e+09,-8.19785e+06
20111007,785000,250400,534600,196262,1.58546e+10,6.99679e+09,-6.48184e+06
20111010,776700,397500,379200,3529,1.58508e+10,7.16721e+09,2.05427e+06
20111011,768000,500800,267200,-18546,1.58484e+10,7.07763e+09,8.04893e+06
20111012,761900,621300,140600,146328,1.58723e+10,7.07499e+09,1.47398e+07
20111013,756100,649900,106200,-67759,1.58591e+10,7.00753e+09,1.74234e+07
20111014,750900,699800,51100,335370,1.59246e+10,7.07947e+09,2.10332e+07
20111017,751300,715800,35500,-486650,1.58327e+10,6.93802e+09,2.16316e+07
20111018,750300,720800,29500,554859,1.59368e+10,7.0809e+09,2.27442e+07
20111019,750000,729900,20100,-290146,1.58813e+10,6.99098e+09,2.24366e+07
20111020,751100,730900,20200,142321,1.59068e+10,7.04025e+09,2.25839e+07
20111021,750400,730200,20200,542650,1.60106e+10,7.18934e+09,2.30985e+07
20111024,749000,729700,19300,403265,1.60897e+10,7.30006e+09,2.35751e+07
20111025,749300,728400,20900,-496136,1.59913e+10,7.12926e+09,2.28358e+07
20111026,749000,731700,17300,246292,1.60371e+10,7.19446e+09,2.3303e+07
20111027,748600,734600,14000,944074,1.62229e+10,7.46285e+09,2.43596e+07
20111028,748300,744200,4100,-19400,1.62199e+10,7.46313e+09,2.44777e+07
20111031,748700,739300,9400,-614359,1.6102e+10,7.29973e+09,2.32755e+07
20111101,749100,735900,13200,-684647,1.59687e+10,7.09859e+09,2.22447e+07
20111102,749800,726600,23200,432434,1.60518e+10,7.24448e+09,2.20971e+07
20111103,750000,706500,43500,442208,1.61376e+10,7.38499e+09,2.11222e+07
20111104,750800,669400,81400,-74072,1.61243e+10,7.36082e+09,1.91526e+07
20111107,751100,642100,109000,78554,1.61378e+10,7.38481e+09,1.76839e+07
20111108,749900,647800,102100,204998,1.61782e+10,7.446e+09,1.83492e+07
20111109,752700,649000,103700,-775133,1.60259e+10,7.18835e+09,1.76391e+07
20111110,753400,625900,127500,183804,1.6062e+10,7.27133e+09,1.68589e+07
20111111,753500,618800,134700,408217,1.6142e+10,7.43342e+09,1.69008e+07
20111114,754000,589200,164800,-164386,1.61109e+10,7.37013e+09,1.56566e+07
20111115,754300,557700,196600,104994,1.61302e+10,7.42121e+09,1.38413e+07
20111116,753800,560600,193200,-173606,1.6097e+10,7.28294e+09,1.31295e+07
20111117,752100,533400,218700,-222022,1.60515e+10,7.13546e+09,1.11706e+07
20111118,750700,474300,276400,21092,1.60565e+10,7.11493e+09,7.05255e+06
20111121,752400,384200,368200,-19794,1.60531e+10,7.01683e+09,2.39116e+06
20111122,749200,249700,499500,43592,1.60608e+10,6.97181e+09,-5.77046e+06
20111123,747400,128900,618500,346416,1.61307e+10,6.80509e+09,-1.33391e+07
20111125,747100,78600,668500,33144,1.61374e+10,6.78216e+09,-1.64558e+07
20111128,746600,73900,672700,-564367,1.60237e+10,6.99887e+09,-1.76381e+07
20111129,746700,73400,673300,-5311,1.60203e+10,7.0055e+09,-1.73882e+07
20111130,746900,95500,651400,-803429,1.58563e+10,7.30271e+09,-1.64322e+07
20111201,742700,221500,521200,25182,1.5859e+10,7.26953e+09,-6.85504e+06
20111202,734600,457400,277200,-24680,1.58517e+10,7.18115e+09,8.08259e+06
20111205,722700,593800,128900,172360,1.58863e+10,7.14036e+09,1.53004e+07
20111206,711800,652500,59300,-34265,1.58806e+10,7.02631e+09,1.96862e+07
20111207,711300,675200,36100,-1899,1.58806e+10,7.01531e+09,2.07673e+07
20111208,712300,673400,38900,-491158,1.57855e+10,6.87697e+09,2.02655e+07
20111209,711700,673500,38200,385597,1.58604e+10,6.99036e+09,2.06338e+07
20111212,711900,665000,46900,-316924,1.57971e+10,6.89742e+09,2.01986e+07
20111213,714300,643500,70800,-217822,1.57542e+10,6.82419e+09,1.87356e+07
20111214,719300,605600,113700,-159670,1.5722e+10,6.78474e+09,1.64858e+07
20111215,723800,567700,156100,97811,1.57405e+10,6.86678e+09,1.44423e+07
20111216,727600,527700,199900,42178,1.5751e+10,6.91156e+09,1.16227e+07
20111219,733800,459000,274800,-20383,1.57471e+10,6.88958e+09,7.13522e+06
20111220,734300,457900,276400,146270,1.57763e+10,7.1043e+09,7.06064e+06
20111221,733300,453000,280300,111869,1.57987e+10,7.10773e+09,7.04328e+06
20111222,732000,477400,254600,34944,1.58053e+10,7.14631e+09,7.71597e+06
20111223,728900,501700,227200,70485,1.58179e+10,7.18186e+09,9.33998e+06
20111227,726500,540600,185900,29347,1.58285e+10,7.17625e+09,1.24309e+07
20111228,726400,555200,171200,-148165,1.58006e+10,7.07593e+09,1.33957e+07
20111229,726200,591200,135000,179541,1.58321e+10,7.14849e+09,1.53881e+07
20111230,726000,594700,131300,-76858,1.58175e+10,7.10886e+09,1.56681e+07
20120103,723200,613300,109900,133740,1.58436e+10,7.16418e+09,1.67364e+07
20120104,719700,628700,91000,4568,1.58466e+10,7.11507e+09,1.784e+07
20120105,717900,666200,51700,119546,1.58665e+10,7.12056e+09,1.99687e+07
20120106,715600,667100,48500,-31820,1.58588e+10,7.06978e+09,2.00121e+07
20120109,715200,668400,46800,102315,1.58774e+10,7.09108e+09,2.03343e+07
20120110,713800,667500,46300,270939,1.59321e+10,7.15651e+09,2.06523e+07
20120111,713200,675300,37900,59376,1.59396e+10,7.15404e+09,2.09249e+07
20120112,712900,668200,44700,115456,1.59594e+10,7.19271e+09,2.05512e+07
20120113,711900,656400,55500,-112773,1.59376e+10,7.16587e+09,1.94493e+07
20120117,712400,654800,57600,82245,1.59528e+10,7.20548e+09,1.9557e+07
20120118,711300,652000,59300,277106,1.60063e+10,7.28332e+09,1.95497e+07
20120119,713500,655300,58200,162919,1.6039e+10,7.3506e+09,1.96732e+07
20120120,713100,650200,62900,-15837,1.60375e+10,7.31315e+09,1.92797e+07
20120123,713200,654200,59000,-61514,1.60258e+10,7.30754e+09,1.97176e+07
20120124,712600,651500,61100,58972,1.60358e+10,7.31692e+09,1.98927e+07
20120125,712600,644600,68000,141119,1.6063e+10,7.38521e+09,1.98384e+07
20120126,712200,640600,71600,-105959,1.60508e+10,7.33257e+09,1.95991e+07
20120127,712300,633700,78600,19356,1.60525e+10,7.34476e+09,1.93751e+07
20120130,712600,611800,100800,-79949,1.60356e+10,7.32384e+09,1.84843e+07
20120131,711300,582400,128900,20368,1.60386e+10,7.324e+09,1.78406e+07
20120201,710700,564800,145900,258824,1.6083e+10,7.40659e+09,1.68963e+07
20120202,710200,562800,147400,12425,1.60842e+10,7.43052e+09,1.6753e+07
20120203,709000,573800,135200,277253,1.61396e+10,7.51617e+09,1.77506e+07
20120206,707900,593300,114600,-46603,1.61285e+10,7.50184e+09,1.905e+07
20120207,705600,636200,69400,28371,1.61342e+10,7.49736e+09,2.06534e+07
20120208,703000,650500,52500,68176,1.61475e+10,7.48826e+09,2.12762e+07
20120209,701400,659900,41500,39062,1.61573e+10,7.48877e+09,2.17525e+07
20120210,701100,644800,56300,-165903,1.61273e+10,7.43748e+09,2.07462e+07
20120213,701300,634500,66800,157523,1.61572e+10,7.4961e+09,2.04245e+07
20120214,702000,637800,64200,-36380,1.61499e+10,7.50495e+09,2.00582e+07
20120215,700900,638700,62200,-64647,1.61432e+10,7.45154e+09,2.0098e+07
20120216,700800,627800,73000,196310,1.61817e+10,7.50352e+09,1.94406e+07
20120217,697700,628300,69400,29009,1.61859e+10,7.48526e+09,2.00085e+07
20120221,697200,620800,76400,-61135,1.61785e+10,7.46322e+09,1.94493e+07
20120222,695000,604100,90900,-90076,1.61632e+10,7.41609e+09,1.89134e+07
20120223,694300,601800,92500,114761,1.61857e+10,7.44309e+09,1.87694e+07
20120224,692600,594000,98600,32754,1.61923e+10,7.44346e+09,1.84149e+07
20120227,692400,591700,100700,34121,1.61965e+10,7.45374e+09,1.81751e+07
20120228,689800,579100,110700,21798,1.62017e+10,7.41705e+09,1.79536e+07
20120229,688800,577500,111300,-86813,1.61839e+10,7.37303e+09,1.79749e+07
20120301,686000,567400,118600,142505,1.62076e+10,7.40493e+09,1.7556e+07
20120302,685900,564800,121100,-73092,1.61929e+10,7.375e+09,1.73648e+07
20120305,683100,540800,142300,-55514,1.61814e+10,7.32335e+09,1.59296e+07
20120306,683100,504000,179100,-236844,1.61368e+10,7.19687e+09,1.38016e+07
20120307,682700,464600,218100,90471,1.61537e+10,7.26329e+09,1.19324e+07
20120308,682800,440600,242200,78728,1.61678e+10,7.34581e+09,1.06826e+07
20120309,682200,444500,237700,75255,1.61826e+10,7.37918e+09,1.08548e+07
20120312,679400,437900,241500,48732,1.61922e+10,7.34689e+09,1.05028e+07
20120313,674600,500100,174500,218834,1.62328e+10,7.42063e+09,1.35636e+07
20120314,665500,536900,128600,-15298,1.62286e+10,7.26306e+09,1.61262e+07
20120315,659700,553000,106700,111423,1.62496e+10,7.2412e+09,1.7323e+07
20120316,653000,559900,93100,-44107,1.6245e+10,7.19458e+09,1.84858e+07
20120319,650600,585400,65200,32753,1.62522e+10,7.18559e+09,2.01351e+07
20120320,648300,588100,60200,-60989,1.6239e+10,7.14447e+09,2.05734e+07
20120321,648200,596700,51500,14948,1.62429e+10,7.14513e+09,2.10719e+07
20120322,647900,594000,53900,-117806,1.62218e+10,7.09081e+09,2.08252e+07
20120323,647600,587000,60600,45151,1.62328e+10,7.10815e+09,2.01357e+07
20120326,647500,581700,65800,295822,1.62905e+10,7.21506e+09,1.97262e+07
20120327,646200,588500,57700,-39670,1.62842e+10,7.18081e+09,2.0003e+07
20120328,646000,589400,56600,-99075,1.62643e+10,7.12882e+09,1.96115e+07
20120329,643900,587100,56800,-19390,1.62616e+10,7.10074e+09,1.97432e+07
20120330,643000,589600,53400,69748,1.62758e+10,7.11033e+09,1.99218e+07
20120402,643000,579200,63800,137645,1.63017e+10,7.17056e+09,1.96884e+07
20120403,643500,555300,88200,-40462,1.62934e+10,7.15747e+09,1.84375e+07
20120404,645600,530200,115400,-162565,1.62638e+10,7.09875e+09,1.73092e+07
20120405,645200,517900,127300,-3913,1.62609e+10,7.10787e+09,1.66661e+07
20120409,646700,488800,157900,-177986,1.62235e+10,7.04026e+09,1.41992e+07
20120410,651900,375200,276700,-99008,1.62036e+10,6.95582e+09,6.89274e+06
20120411,654700,290900,363800,22720,1.62072e+10,7.05129e+09,1.74244e+06
20120412,655900,265100,390800,-75358,1.61943e+10,7.16823e+09,20761
20120413,656700,234500,422200,143282,1.62181e+10,7.12079e+09,-1.64789e+06
20120416,657000,228200,428800,30464,1.62275e+10,7.11772e+09,-2.58576e+06
20120417,656000,236300,419700,-79001,1.62151e+10,7.20017e+09,-1.82088e+06
20120418,653400,266000,387400,74541,1.62282e+10,7.16375e+09,763964
20120419,653100,276400,376700,34890,1.62368e+10,7.12121e+09,1.64262e+06
20120420,653000,298200,354800,86766,1.6253e+10,7.14311e+09,2.82918e+06
20120423,652600,306800,345800,-36961,1.62456e+10,7.06902e+09,3.65253e+06
20120424,652800,313200,339600,21544,1.62508e+10,7.07557e+09,3.54643e+06
20120425,651300,313200,338100,44263,1.62577e+10,7.15514e+09,3.42984e+06
20120426,649000,380700,268300,61104,1.62699e+10,7.21126e+09,6.20437e+06
20120427,644800,422000,222800,59649,1.62895e+10,7.20066e+09,8.80028e+06
20120430,641400,476700,164700,-27294,1.62876e+10,7.11512e+09,1.22893e+07
20120501,638000,501400,136600,91182,1.63042e+10,7.1156e+09,1.42803e+07
20120502,637300,518000,119300,-15129,1.62977e+10,7.10188e+09,1.52794e+07
20120503,637300,508400,128900,-93483,1.62815e+10,7.02412e+09,1.44459e+07
20120504,638500,498800,139700,-187003,1.62466e+10,6.92525e+09,1.3325e+07
20120507,640200,471600,168600,67208,1.62547e+10,6.96226e+09,1.1619e+07
20120508,643400,418300,225100,-52513,1.62448e+10,6.96248e+09,8.15663e+06
20120509,648300,367200,281100,-7386,1.62451e+10,6.97712e+09,4.1956e+06
20120510,650100,337600,312500,82360,1.62609e+10,7.00351e+09,1.7307e+06
20120511,650700,319500,331200,47487,1.62701e+10,7.00858e+09,86378
20120514,652100,293900,358200,92895,1.62855e+10,6.93829e+09,-2.09632e+06
20120515,653600,267200,386400,55295,1.62957e+10,6.91741e+09,-3.32235e+06
20120516,654400,254400,400000,96311,1.6316e+10,6.88694e+09,-4.41778e+06
20120517,656800,220400,436400,157658,1.63466e+10,6.75485e+09,-6.43899e+06
20120518,659200,171800,487400,104953,1.63662e+10,6.72518e+09,-1.00353e+07
20120521,660400,143900,516500,-316622,1.63092e+10,6.87656e+09,-1.18539e+07
20120522,660100,122800,537300,-8361,1.63096e+10,6.88986e+09,-1.31938e+07
20120523,660800,114600,546200,-82350,1.62917e+10,6.92502e+09,-1.39497e+07
20120524,660200,120900,539300,25244,1.62952e+10,6.93052e+09,-1.32181e+07
20120525,660200,155600,504600,50965,1.63062e+10,6.91085e+09,-1.04307e+07
20120529,659900,223800,436100,-123074,1.62836e+10,6.97899e+09,-5.97889e+06
20120530,659100,245800,413300,151744,1.63149e+10,6.85648e+09,-4.00127e+06
20120531,660000,259800,400200,35324,1.63224e+10,6.84263e+09,-2.79226e+06
20120601,661300,257100,404200,169350,1.63536e+10,6.64487e+09,-2.8492e+06
20120604,663100,228900,434200,93927,1.63667e+10,6.65194e+09,-4.5537e+06
20120605,665700,189700,476000,-137202,1.63428e+10,6.74532e+09,-7.45647e+06
20120606,665800,189500,476300,-251451,1.62976e+10,6.89793e+09,-8.1159e+06
20120607,666700,196900,469800,24445,1.63015e+10,6.89731e+09,-7.73487e+06
20120608,667200,270000,397200,1872,1.63025e+10,6.96881e+09,-2.06946e+06
20120611,667600,341500,326100,15855,1.63021e+10,6.86852e+09,3.12149e+06
20120612,669000,428800,240200,123233,1.63293e+10,6.96662e+09,9.24621e+06
20120613,670000,445400,224600,-55655,1.6316e+10,6.89399e+09,9.77215e+06
20120614,669800,460400,209400,118963,1.63409e+10,6.95434e+09,1.07968e+07
20120615,671900,473400,198500,104835,1.63655e+10,7.06729e+09,1.13083e+07
20120618,672900,532800,140100,39677,1.63738e+10,7.1129e+09,1.36882e+07
20120619,671100,563000,108100,129949,1.64016e+10,7.17204e+09,1.56781e+07
20120620,669900,587300,82600,-38382,1.63938e+10,7.13247e+09,1.75755e+07
20120621,670700,598200,72500,-384523,1.63199e+10,6.97087e+09,1.7953e+07
20120622,671500,594700,76800,126615,1.63421e+10,7.02933e+09,1.79765e+07
20120625,673000,583200,89800,-242021,1.62966e+10,6.926e+09,1.68103e+07
20120626,674000,574200,99800,115012,1.63197e+10,6.97414e+09,1.58936e+07
20120627,677800,512000,165800,99994,1.63369e+10,7.03555e+09,1.2825e+07
20120628,678500,504800,173700,-28379,1.63326e+10,7.01172e+09,1.19745e+07
20120629,679000,513800,165200,282168,1.6389e+10,7.20049e+09,1.20738e+07
20120702,676200,521600,154600,95828,1.64141e+10,7.1891e+09,1.29933e+07
20120703,674700,550400,124300,188097,1.64612e+10,7.24118e+09,1.49984e+07
20120705,674300,595100,79200,-89610,1.64427e+10,7.2282e+09,1.769e+07
20120706,676600,614200,62400,-199645,1.6399e+10,7.18883e+09,1.90518e+07
20120709,677000,612100,64900,-75468,1.6384e+10,7.16217e+09,1.88639e+07
20120710,675700,603700,72000,-155751,1.6348e+10,7.043e+09,1.78614e+07
20120711,677800,560800,117000,29448,1.63517e+10,7.05584e+09,1.53056e+07
20120712,681400,497000,184400,-18529,1.63488e+10,7.08554e+09,1.19738e+07
20120713,683000,455900,227100,161170,1.63758e+10,7.21584e+09,9.92882e+06
20120716,683700,440200,243500,42747,1.63842e+10,7.20264e+09,8.76147e+06
20120717,682900,452200,230700,90959,1.64009e+10,7.24966e+09,9.31699e+06
20120718,683600,451900,231700,-33659,1.6392e+10,7.32664e+09,1.03579e+07
20120719,683200,484200,199000,-3058,1.63872e+10,7.35052e+09,1.30575e+07
20120720,682600,494100,188500,-135385,1.63598e+10,7.23918e+09,1.419e+07
20120723,683900,483900,200000,-96803,1.63459e+10,7.14871e+09,1.42547e+07
20120724,685400,460800,224600,-118075,1.6324e+10,7.09512e+09,1.29556e+07
20120725,688100,423400,264700,19203,1.633e+10,7.13121e+09,1.04688e+07
20120726,691300,383300,308000,209929,1.63611e+10,7.29786e+09,7.74053e+06
20120727,689900,378800,311100,172062,1.6393e+10,7.43026e+09,7.80031e+06
20120730,686800,388000,298800,682,1.63929e+10,7.39064e+09,8.47401e+06
20120731,684400,423700,260700,-87365,1.63772e+10,7.29845e+09,1.11649e+07
20120801,682100,461900,220200,-45762,1.63688e+10,7.23404e+09,1.28051e+07
20120802,680200,490000,190200,-92723,1.63465e+10,7.17055e+09,1.40017e+07
20120803,680000,486700,193300,278589,1.64016e+10,7.31351e+09,1.40368e+07
20120806,678700,505800,172900,58095,1.64137e+10,7.30915e+09,1.4544e+07
20120807,675000,525200,149800,115434,1.64369e+10,7.32265e+09,1.54581e+07
20120808,674200,541500,132700,27478,1.64423e+10,7.31734e+09,1.61925e+07
20120809,673100,583800,89300,36326,1.64493e+10,7.29801e+09,1.78882e+07
20120810,673600,589100,84500,42133,1.64563e+10,7.32026e+09,1.83179e+07
20120813,673000,591700,81300,-41456,1.64476e+10,7.2898e+09,1.84979e+07
20120814,672600,602400,70200,-18686,1.64436e+10,7.2852e+09,1.88291e+07
20120815,672300,611600,60700,47265,1.64519e+10,7.30502e+09,1.90991e+07
20120816,671100,614900,56200,179962,1.64862e+10,7.34289e+09,1.99736e+07
20120817,670400,615400,55000,70210,1.6498e+10,7.36203e+09,2.02101e+07
20120820,670200,618500,51700,-59391,1.64874e+10,7.33548e+09,2.01374e+07
20120821,669700,621100,48600,-50367,1.64782e+10,7.31085e+09,2.01738e+07
20120822,669500,614700,54800,-24530,1.64736e+10,7.31514e+09,1.9675e+07
20120823,671000,602000,69000,-152609,1.6443e+10,7.288e+09,1.87176e+07
20120824,670700,582800,87900,96212,1.64606e+10,7.33258e+09,1.82209e+07
20120827,671100,571700,99400,-38022,1.6452e+10,7.33448e+09,1.75862e+07
20120828,670900,565600,105300,-5610,1.64504e+10,7.329e+09,1.69682e+07
20120829,672100,555400,116700,31219,1.6457e+10,7.35584e+09,1.66441e+07
20120830,672000,548400,123600,-112000,1.6437e+10,7.29831e+09,1.55574e+07
20120831,671100,532900,138200,106290,1.64568e+10,7.33011e+09,1.50304e+07
20120904,670100,511400,158700,33965,1.64649e+10,7.32272e+09,1.27698e+07
20120905,669700,509300,160400,-28470,1.64585e+10,7.29341e+09,1.24878e+07
20120906,668800,519800,149000,289228,1.65111e+10,7.43655e+09,1.36091e+07
20120907,665500,522900,142600,63209,1.65228e+10,7.42798e+09,1.44453e+07
20120910,662700,561900,100800,-85798,1.65048e+10,7.36696e+09,1.63773e+07
20120911,660200,585700,74500,58077,1.65165e+10,7.36201e+09,1.83924e+07
20120912,655100,594900,60200,96448,1.65323e+10,7.33165e+09,1.9492e+07
20120913,654400,600200,54200,288234,1.65876e+10,7.42291e+09,2.01195e+07
20120914,652500,613100,39400,138796,1.66118e+10,7.44768e+09,2.0924e+07
20120917,651800,615000,36800,-131521,1.65881e+10,7.40147e+09,2.10197e+07
20120918,651400,617500,33900,-80316,1.65746e+10,7.36616e+09,2.12662e+07
20120919,650700,617900,32800,64802,1.65859e+10,7.37315e+09,2.14309e+07
20120920,650400,612500,37900,-72833,1.6573e+10,7.346e+09,2.10973e+07
20120921,650600,609800,40800,16597,1.65751e+10,7.35695e+09,2.07707e+07
20120924,650700,588800,61900,-72168,1.65599e+10,7.33735e+09,1.96102e+07
20120925,651400,577300,74100,-232572,1.65188e+10,7.2674e+09,1.83103e+07
20120926,653100,554100,99000,-120371,1.6496e+10,7.23338e+09,1.72323e+07
20120927,652800,518800,134000,143867,1.65229e+10,7.30511e+09,1.53582e+07
20120928,653200,489500,163700,-20055,1.65209e+10,7.28914e+09,1.36833e+07
20121001,654100,425500,228600,58166,1.65361e+10,7.30717e+09,1.01339e+07
20121002,654100,407500,246600,823,1.65382e+10,7.31771e+09,9.17896e+06
20121003,653400,406300,247100,113380,1.65605e+10,7.33438e+09,9.12147e+06
20121004,652400,414700,237700,66738,1.6574e+10,7.37921e+09,9.42664e+06
20121005,650200,415600,234600,18352,1.65777e+10,7.35864e+09,9.50725e+06
20121008,647600,436000,211600,-25458,1.65717e+10,7.31114e+09,1.04035e+07
20121009,647000,444900,202100,-140593,1.65411e+10,7.22217e+09,1.11481e+07
20121010,647500,434600,212900,-42723,1.65307e+10,7.18918e+09,1.03949e+07
20121011,646700,420700,226000,44675,1.65408e+10,7.20812e+09,8.96738e+06
20121012,646200,408300,237900,-27290,1.65379e+10,7.17464e+09,7.98268e+06
20121015,645600,393500,252100,83681,1.65544e+10,7.23219e+09,6.97814e+06
20121016,644400,403500,240900,35561,1.65605e+10,7.2953e+09,7.95967e+06
20121017,641700,424900,216800,121286,1.6582e+10,7.30494e+09,9.75081e+06
20121018,636100,446000,190100,42191,1.65925e+10,7.25178e+09,1.10462e+07
20121019,636400,463100,173300,-178681,1.65577e+10,7.14425e+09,1.3012e+07
20121022,636200,469300,166900,-22275,1.65547e+10,7.13163e+09,1.35856e+07
20121023,638000,449600,188400,-147211,1.65243e+10,7.06042e+09,1.19918e+07
20121024,639900,417900,222000,-54281,1.65112e+10,7.06383e+09,9.43077e+06
20121025,642100,381000,261100,19140,1.65169e+10,7.10875e+09,6.7796e+06
20121026,644300,349900,294400,16476,1.65159e+10,7.13219e+09,4.19018e+06
20121031,646400,316900,329500,111059,1.65329e+10,7.18192e+09,2.87779e+06
20121101,644600,319000,325600,65158,1.65461e+10,7.2585e+09,2.995e+06
20121102,643500,324900,318600,4513,1.65477e+10,7.19014e+09,3.47531e+06
20121105,642800,352100,290700,-21003,1.6545e+10,7.19927e+09,4.77e+06
20121106,641300,391300,250000,76071,1.65597e+10,7.24409e+09,7.04468e+06
20121107,641800,384300,257500,-154722,1.65313e+10,7.11011e+09,6.28811e+06
20121108,643300,363300,280000,-61604,1.65179e+10,7.0317e+09,4.22256e+06
20121109,644500,345200,299300,7603,1.65185e+10,7.04509e+09,3.29976e+06
20121112,645600,326800,318800,19883,1.65231e+10,7.06588e+09,1.70027e+06
20121113,649700,257900,391800,42904,1.65335e+10,7.10571e+09,-2.03764e+06
20121114,650500,240200,410300,45690,1.65402e+10,7.00401e+09,-3.67676e+06
20121115,652200,218800,433400,6352,1.65408e+10,7.01355e+09,-5.06961e+06
20121116,651900,214700,437200,-41764,1.65324e+10,7.06084e+09,-5.72931e+06
20121119,652400,220000,432400,-77820,1.65165e+10,7.19271e+09,-5.54407e+06
20121120,652800,210100,442700,13273,1.652e+10,7.21142e+09,-5.17557e+06
20121121,651700,253900,397800,20515,1.65249e+10,7.21812e+09,-1.58355e+06
20121123,650300,327500,322800,69350,1.65397e+10,7.29022e+09,3.3972e+06
20121126,649000,415600,233400,-52065,1.65288e+10,7.24661e+09,8.93461e+06
20121127,648400,472400,176000,-67530,1.65161e+10,7.20096e+09,1.11457e+07
20121128,647300,521600,125700,112789,1.65375e+10,7.24475e+09,1.43281e+07
20121129,645500,551500,94000,95774,1.65568e+10,7.24762e+09,1.66126e+07
20121130,643900,573500,70400,14692,1.65601e+10,7.21878e+09,1.8258e+07
20121203,643600,589200,54400,-112616,1.65394e+10,7.1744e+09,1.94012e+07
20121204,643300,592800,50500,-7789,1.65389e+10,7.15883e+09,2.01691e+07
20121205,644900,591800,53100,63670,1.65531e+10,7.18506e+09,1.99757e+07
20121206,644500,593200,51300,52313,1.65636e+10,7.20277e+09,1.99922e+07
20121207,644200,597500,46700,84501,1.65801e+10,7.2186e+09,2.00786e+07
20121210,643100,599000,44100,49412,1.65886e+10,7.22375e+09,1.99583e+07
20121211,642400,598700,43700,126742,1.66146e+10,7.25857e+09,2.00955e+07
20121212,641900,605100,36800,3385,1.66152e+10,7.24967e+09,2.02814e+07
20121213,642300,600700,41600,-110746,1.65912e+10,7.2079e+09,1.9595e+07
20121214,642800,595900,46900,-51874,1.65808e+10,7.1963e+09,1.89374e+07
20121217,642500,595300,47200,209966,1.66237e+10,7.28501e+09,1.92707e+07
20121218,644200,594100,50100,248812,1.66729e+10,7.39882e+09,1.91892e+07
20121219,643100,593900,49200,-99108,1.66519e+10,7.33338e+09,1.90698e+07
20121220,642500,592600,49900,150369,1.66816e+10,7.35777e+09,1.92108e+07
20121221,642500,592400,50100,-161649,1.66519e+10,7.31606e+09,1.9427e+07
20121224,642600,595500,47100,-43350,1.66432e+10,7.30129e+09,1.95228e+07
20121226,642700,590400,52300,-132142,1.66204e+10,7.22026e+09,1.89199e+07
20121227,642700,582400,60300,-18898,1.66164e+10,7.2254e+09,1.83002e+07
20121228,643200,544600,98600,-177689,1.65827e+10,7.16135e+09,1.54698e+07
20121231,643200,533600,109600,250584,1.66291e+10,7.28739e+09,1.53824e+07
20130102,642900,539600,103300,403588,1.66996e+10,7.45277e+09,1.61438e+07
20130103,641300,547600,93700,-11995,1.66973e+10,7.43909e+09,1.7564e+07
20130104,640600,586000,54600,160209,1.67276e+10,7.49759e+09,1.99582e+07
20130107,634700,612900,21800,-74672,1.67135e+10,7.42282e+09,2.20629e+07
20130108,633100,614000,19100,-85053,1.66943e+10,7.38086e+09,2.24108e+07
20130109,632600,608700,23900,98961,1.67134e+10,7.41853e+09,2.22404e+07
20130110,632200,605400,26800,142702,1.67431e+10,7.44761e+09,2.23628e+07
20130111,631300,601900,29400,-8098,1.67439e+10,7.42156e+09,2.20653e+07
20130114,631000,601400,29600,5631,1.67438e+10,7.42438e+09,2.20559e+07
20130115,630900,594300,36600,62931,1.67542e+10,7.4376e+09,2.17534e+07
20130116,630600,600900,29700,-34666,1.67479e+10,7.41373e+09,2.20766e+07
20130117,629900,606700,23200,206914,1.67878e+10,7.47024e+09,2.27422e+07
20130118,629300,604400,24900,96128,1.68059e+10,7.48331e+09,2.25733e+07
20130122,627400,602400,25000,131066,1.68293e+10,7.49594e+09,2.29076e+07
20130123,627200,595600,31600,-16684,1.68242e+10,7.50834e+09,2.24105e+07
20130124,627000,596100,30900,152169,1.68541e+10,7.55583e+09,2.26583e+07
20130125,625800,596100,29700,179086,1.68895e+10,7.59936e+09,2.29087e+07
20130128,625600,590900,34700,-86598,1.68711e+10,7.55774e+09,2.24338e+07
20130129,625600,593800,31800,86377,1.68891e+10,7.58941e+09,2.24073e+07
20130130,627300,595400,31900,-70332,1.6876e+10,7.59978e+09,2.21844e+07
20130131,625600,586900,38700,-16444,1.68673e+10,7.58745e+09,2.17687e+07
20130201,625500,584200,41300,199981,1.69101e+10,7.64943e+09,2.16096e+07
20130204,625300,577500,47800,-217612,1.6867e+10,7.58053e+09,2.06746e+07
20130205,625200,579500,45700,219246,1.6911e+10,7.63911e+09,2.07611e+07
20130206,624900,574400,50500,40851,1.69165e+10,7.66337e+09,2.03275e+07
20130207,624000,567300,56700,-40882,1.69088e+10,7.64252e+09,1.99001e+07
20130208,622800,558800,64000,124391,1.69323e+10,7.67637e+09,1.96292e+07
20130211,621300,561400,59900,-24689,1.69276e+10,7.65256e+09,1.95714e+07
20130212,619900,561000,58900,73241,1.6942e+10,7.65043e+09,1.98172e+07
20130213,619800,568300,51500,29992,1.69446e+10,7.66525e+09,2.00919e+07
20130214,619600,572800,46800,-28766,1.69357e+10,7.66302e+09,2.04182e+07
20130215,617900,563900,54000,-4780,1.69335e+10,7.64982e+09,1.98087e+07
20130219,615400,559600,55800,153719,1.69622e+10,7.65839e+09,1.97347e+07
20130220,615500,544400,71100,-274721,1.69151e+10,7.53057e+09,1.83803e+07
20130221,614900,532800,82100,-146456,1.68854e+10,7.47011e+09,1.71333e+07
20130222,613500,523700,89800,204533,1.69256e+10,7.52794e+09,1.66964e+07
20130225,608400,454800,153600,-216242,1.68843e+10,7.30696e+09,1.26089e+07
20130226,607400,405200,202200,70844,1.68973e+10,7.34978e+09,9.62371e+06
20130227,604800,385600,219200,116250,1.69206e+10,7.41691e+09,8.98449e+06
20130228,604000,385700,218300,10844,1.69216e+10,7.40479e+09,9.10893e+06
20130301,602100,389700,212400,29108,1.69298e+10,7.43221e+09,9.22099e+06
20130304,601000,407500,193500,74202,1.69425e+10,7.44331e+09,1.1437e+07
20130305,597100,444500,152600,146160,1.69692e+10,7.48025e+09,1.4327e+07
20130306,595100,476500,118600,-1273,1.69685e+10,7.45461e+09,1.54623e+07
20130307,590900,514100,76800,1047,1.69698e+10,7.41081e+09,1.76915e+07
20130308,586700,533100,53600,123714,1.69926e+10,7.40592e+09,1.94765e+07
20130311,583800,536800,47000,59513,1.70045e+10,7.38639e+09,2.02895e+07
20130312,582300,545300,37000,-41441,1.69984e+10,7.34187e+09,2.10627e+07
20130313,581300,545600,35700,96851,1.70169e+10,7.34997e+09,2.13556e+07
20130314,580000,552900,27100,115601,1.70392e+10,7.36026e+09,2.19e+07
20130315,579200,558300,20900,-53098,1.70291e+10,7.32188e+09,2.22913e+07
20130318,579200,557100,22100,-141583,1.70017e+10,7.28338e+09,2.2119e+07
20130319,579200,554100,25100,-68079,1.69884e+10,7.25841e+09,2.18043e+07
20130320,578800,544600,34200,182601,1.70245e+10,7.30453e+09,2.17831e+07
20130321,578400,529800,48600,-194880,1.69871e+10,7.22945e+09,2.0273e+07
20130322,578600,523900,54700,120944,1.70101e+10,7.27246e+09,1.95572e+07
20130325,579100,515800,63300,-46957,1.70017e+10,7.24956e+09,1.85687e+07
20130326,579900,501600,78300,158981,1.70311e+10,7.3248e+09,1.76467e+07
20130327,580100,491000,89100,5102,1.70321e+10,7.33344e+09,1.69409e+07
20130328,579600,493400,86200,132967,1.70576e+10,7.37853e+09,1.7046e+07
20130401,578700,490900,87800,-81667,1.70419e+10,7.30882e+09,1.66519e+07
20130402,577600,486400,91200,67200,1.70558e+10,7.31707e+09,1.64211e+07
20130403,579000,456700,122300,-180450,1.70196e+10,7.25243e+09,1.4782e+07
20130404,578600,416900,161700,89087,1.70396e+10,7.29451e+09,1.27646e+07
20130405,577500,373000,204500,-48148,1.70329e+10,7.257e+09,1.04103e+07
20130408,576800,364100,212700,68938,1.70464e+10,7.30616e+09,9.97585e+06
20130409,576100,359200,216900,-30428,1.70392e+10,7.31086e+09,9.59858e+06
20130410,575600,393800,181800,151142,1.70675e+10,7.39668e+09,1.19022e+07
20130411,573100,416800,156300,103102,1.70881e+10,7.41917e+09,1.37431e+07
20130412,570100,460000,110100,-9733,1.70851e+10,7.35231e+09,1.62208e+07
20130415,569900,463400,106500,-358994,1.70118e+10,7.15853e+09,1.59526e+07
20130416,569800,470600,99200,216836,1.70526e+10,7.27431e+09,1.63984e+07
20130417,569900,439100,130800,-125683,1.70286e+10,7.1709e+09,1.36021e+07
20130418,572600,366800,205800,-15937,1.70219e+10,7.10252e+09,9.36929e+06
20130419,573600,327100,246500,170345,1.70493e+10,7.20153e+09,6.34604e+06
20130422,573800,322100,251700,-4942,1.70508e+10,7.23022e+09,6.22848e+06
20130423,573600,320200,253400,27854,1.70572e+10,7.31572e+09,6.22005e+06
20130424,573000,321200,251800,-85343,1.70391e+10,7.30583e+09,6.80053e+06
20130425,571800,393400,178400,86475,1.70568e+10,7.32729e+09,1.14399e+07
20130426,568600,432400,136200,-41617,1.70476e+10,7.24572e+09,1.42333e+07
20130429,566200,462100,104100,84820,1.70663e+10,7.26329e+09,1.68256e+07
20130430,566300,474600,91700,87305,1.70863e+10,7.28961e+09,1.80435e+07
20130501,564200,479900,84300,-160976,1.70545e+10,7.18413e+09,1.76935e+07
20130502,563600,472900,90700,156115,1.70854e+10,7.25341e+09,1.70324e+07
20130503,562000,488000,74000,202916,1.71249e+10,7.33269e+09,1.81289e+07
20130506,560500,485000,75500,13667,1.71279e+10,7.32261e+09,1.798e+07
20130507,558700,496900,61800,114498,1.71472e+10,7.3415e+09,1.90487e+07
20130508,556700,516000,40700,59254,1.716e+10,7.33682e+09,2.05259e+07
20130509,555800,523000,32800,-77906,1.71442e+10,7.29995e+09,2.12423e+07
20130510,554200,523800,30400,123071,1.71678e+10,7.32816e+09,2.15225e+07
20130513,553700,521400,32300,-35089,1.71617e+10,7.31902e+09,2.13353e+07
20130514,553200,514600,38600,266269,1.72138e+10,7.40347e+09,2.09554e+07
20130515,552600,514700,37900,121784,1.72387e+10,7.42699e+09,2.16806e+07
20130516,552700,513600,39100,-164473,1.72043e+10,7.36334e+09,2.14023e+07
20130517,551700,519200,32500,260586,1.72542e+10,7.4323e+09,2.22086e+07
20130520,551000,518500,32500,-27894,1.72505e+10,7.40697e+09,2.22593e+07
20130521,551000,522100,28900,24515,1.72549e+10,7.4178e+09,2.26557e+07
20130522,551200,518100,33100,-242825,1.72085e+10,7.33259e+09,2.18373e+07
20130523,551500,513000,38500,-52276,1.72022e+10,7.3044e+09,2.14327e+07
20130524,551400,494000,57400,-18189,1.71979e+10,7.30242e+09,1.98456e+07
20130528,551100,482400,68700,195095,1.72365e+10,7.34459e+09,1.88177e+07
20130529,550300,454400,95900,-109825,1.7216e+10,7.25374e+09,1.63456e+07
20130530,550400,439000,111400,93031,1.7235e+10,7.2843e+09,1.50034e+07
20130531,551100,410700,140400,-179570,1.71974e+10,7.19759e+09,1.20596e+07
20130603,551500,395900,155600,41254,1.72043e+10,7.22592e+09,1.01078e+07
20130604,553700,371100,182600,-32919,1.71964e+10,7.20461e+09,7.63895e+06
20130605,555100,334200,220900,-66922,1.71834e+10,7.11871e+09,3.60492e+06
20130606,554200,295000,259200,-16148,1.71814e+10,7.18243e+09,-292645
20130607,553900,288900,265000,41128,1.71889e+10,7.27655e+09,-626415
20130610,553000,280400,272600,44501,1.71974e+10,7.25356e+09,-960596
20130611,553100,273100,280000,-2860,1.71959e+10,7.17508e+09,-1.78503e+06
20130612,552700,286500,266200,22447,1.72008e+10,7.11101e+09,-796990
20130613,552000,300100,251900,-21435,1.71985e+10,7.22799e+09,792647
20130614,550600,306700,243900,-32872,1.71912e+10,7.17875e+09,1.29748e+06
20130617,550200,317700,232500,21521,1.71996e+10,7.23615e+09,2.51482e+06
20130618,548500,362000,186500,75663,1.72151e+10,7.26736e+09,7.70763e+06
20130619,546100,396500,149600,-119424,1.71922e+10,7.13279e+09,1.08971e+07
20130620,546400,390300,156100,-218075,1.71476e+10,6.9418e+09,1.01952e+07
20130621,546700,363400,183300,24700,1.71533e+10,6.953e+09,8.05896e+06
20130624,547600,313900,233700,36235,1.71632e+10,6.86578e+09,3.75817e+06
20130625,548300,251200,297100,-60751,1.7151e+10,6.94739e+09,-2.23606e+06
20130626,546600,224900,321700,-38734,1.71416e+10,6.98022e+09,-4.09104e+06
20130627,545200,236200,309000,-49899,1.71326e+10,7.02678e+09,-3.07402e+06
20130628,544600,256800,287800,36419,1.71423e+10,6.98849e+09,-873838
20130701,544100,330000,214100,54412,1.7159e+10,7.01899e+09,4.98655e+06
20130702,543000,372500,170500,11594,1.71583e+10,6.98644e+09,9.22027e+06
20130703,541900,383800,158100,21019,1.71632e+10,6.97506e+09,1.08022e+07
20130705,540700,393300,147400,177577,1.7195e+10,7.03323e+09,1.22308e+07
20130708,538700,409900,128800,68436,1.72088e+10,7.03763e+09,1.39668e+07
20130709,537500,447600,89900,119629,1.72316e+10,7.0568e+09,1.6499e+07
20130710,535900,455300,80600,39874,1.72415e+10,7.04402e+09,1.75761e+07
20130711,531000,485600,45400,231600,1.72923e+10,7.07384e+09,2.02651e+07
20130712,529700,494000,35700,83447,1.73107e+10,7.0815e+09,2.12201e+07
20130715,528900,509700,19200,24525,1.73133e+10,7.08477e+09,2.23044e+07
20130716,529200,514900,14300,-113796,1.72923e+10,7.04475e+09,2.25662e+07
20130717,529600,518800,10800,58615,1.73038e+10,7.07901e+09,2.31127e+07
20130718,529600,521200,8400,161071,1.73323e+10,7.12473e+09,2.3614e+07
20130719,529500,519700,9800,79575,1.73481e+10,7.14529e+09,2.35711e+07
20130722,533300,528100,5200,42419,1.73567e+10,7.1921e+09,2.36897e+07
20130723,533100,521800,11300,-45521,1.73481e+10,7.16253e+09,2.31412e+07
20130724,532200,516600,15600,-152462,1.73184e+10,7.09022e+09,2.24826e+07
20130725,532600,511000,21600,151188,1.73471e+10,7.13518e+09,2.22632e+07
20130726,533700,498400,35300,7261,1.73496e+10,7.13531e+09,2.15292e+07
20130729,534100,494300,39800,-82950,1.73351e+10,7.11318e+09,2.08616e+07
20130730,534200,481400,52800,63710,1.73489e+10,7.12617e+09,1.96184e+07
20130731,534800,464300,70500,51016,1.73589e+10,7.13603e+09,1.81884e+07
20130801,534700,455500,79200,293357,1.74144e+10,7.26372e+09,1.75066e+07
20130802,534300,453500,80800,30037,1.74159e+10,7.2735e+09,1.66872e+07
20130805,533500,460300,73200,-31057,1.74082e+10,7.25383e+09,1.68519e+07
20130806,532600,459900,72700,-112143,1.73838e+10,7.20207e+09,1.73842e+07
20130807,532900,455400,77500,-87738,1.73668e+10,7.1662e+09,1.70778e+07
20130808,532900,447400,85500,77825,1.73826e+10,7.20522e+09,1.65918e+07
20130809,532900,436800,96100,-36847,1.73732e+10,7.19192e+09,1.53443e+07
20130812,533000,426900,106100,-20464,1.73696e+10,7.18218e+09,1.5104e+07
20130813,533000,422500,110500,63515,1.7382e+10,7.19215e+09,1.47543e+07
20130814,532300,405800,126500,-86938,1.73668e+10,7.13332e+09,1.3867e+07
20130815,533000,378200,154800,-216496,1.73208e+10,7.02772e+09,1.08457e+07
20130816,534700,339300,195400,37894,1.73304e+10,7.03293e+09,7.12e+06
20130819,535500,308300,227200,-25219,1.7325e+10,7.0013e+09,3.73401e+06
20130820,535700,272100,263600,-20366,1.73224e+10,7.0627e+09,386010
20130821,535700,225300,310400,36228,1.7331e+10,7.02974e+09,-3.67796e+06
20130822,535900,224800,311100,428,1.73317e+10,7.10537e+09,-4.0312e+06
20130823,535800,231300,304500,-17107,1.73275e+10,7.12607e+09,-3.30828e+06
20130826,535300,247800,287500,28295,1.7336e+10,7.09174e+09,-1.34671e+06
20130827,536100,231300,304800,10893,1.73372e+10,6.9784e+09,-2.57093e+06
20130828,535600,206900,328700,19434,1.73429e+10,6.99124e+09,-3.75337e+06
20130829,532900,181900,351000,-22489,1.73387e+10,6.96775e+09,-5.1832e+06
20130830,532500,164500,368000,34880,1.73459e+10,6.94065e+09,-6.26254e+06
20130903,532100,156900,375200,6531,1.73479e+10,6.98059e+09,-7.0924e+06
20130904,531900,175700,356200,-54815,1.73399e+10,7.03753e+09,-5.56299e+06
20130905,530800,225800,305000,20718,1.73441e+10,7.03315e+09,-1.23244e+06
20130906,530300,274700,255600,5622,1.73446e+10,7.02683e+09,2.28244e+06
20130909,527800,324100,203700,81551,1.7357e+10,7.0545e+09,7.77093e+06
20130910,524300,395700,128600,149722,1.73877e+10,7.06298e+09,1.34389e+07
20130911,521200,428400,92800,101769,1.74092e+10,7.057e+09,1.69486e+07
20130912,519800,442000,77800,-83230,1.73935e+10,7.02461e+09,1.79846e+07
20130913,518700,459100,59600,47942,1.74021e+10,7.03598e+09,1.94431e+07
20130916,518100,478100,40000,153784,1.74333e+10,7.07425e+09,2.03778e+07
20130917,518300,478200,40100,102301,1.74545e+10,7.10654e+09,2.07114e+07
20130918,517500,491500,26000,261730,1.75085e+10,7.19439e+09,2.20975e+07
20130919,517100,498200,18900,-23643,1.7506e+10,7.18463e+09,2.26527e+07
20130920,516900,499000,17900,-171262,1.74733e+10,7.13013e+09,2.25811e+07
20130923,517000,498100,18900,-128639,1.74471e+10,7.08816e+09,2.23346e+07
20130924,518200,478200,40000,2327,1.74469e+10,7.09753e+09,2.14177e+07
20130925,518700,473900,44800,-44468,1.74384e+10,7.08391e+09,2.09977e+07
20130926,519100,464600,54500,75853,1.74524e+10,7.12903e+09,2.03667e+07
20130927,519800,443300,76500,-116296,1.74333e+10,7.08307e+09,1.91897e+07
20130930,520300,433400,86900,-80642,1.74162e+10,7.06316e+09,1.8182e+07
20131001,520600,417300,103300,141155,1.74433e+10,7.12426e+09,1.68855e+07
20131002,520600,413500,107100,-4191,1.74419e+10,7.11292e+09,1.63932e+07
20131003,521500,394700,126800,-141625,1.74147e+10,7.06483e+09,1.44912e+07
20131004,522200,372300,149900,118978,1.74415e+10,7.12977e+09,1.21153e+07
20131007,522300,361200,161100,-129351,1.74159e+10,7.0628e+09,1.13107e+07
20131008,523100,333900,189200,-119694,1.73939e+10,6.97557e+09,8.28842e+06
20131009,524600,292800,231800,-15746,1.73894e+10,6.98403e+09,4.38518e+06
20131010,524600,291200,233400,68018,1.74005e+10,7.14006e+09,3.64058e+06
20131011,524700,293000,231700,36087,1.74083e+10,7.18185e+09,3.44633e+06
20131014,524400,339800,184600,24855,1.74142e+10,7.20882e+09,6.92086e+06
20131015,523200,372000,151200,-61337,1.7403e+10,7.128e+09,9.78069e+06
20131016,520100,420100,100000,250404,1.74529e+10,7.19198e+09,1.53194e+07
20131017,514700,439300,75400,149523,1.7485e+10,7.15323e+09,1.77171e+07
20131018,512500,452900,59600,112452,1.75071e+10,7.16847e+09,1.93327e+07
20131021,511700,451600,60100,5344,1.75081e+10,7.16148e+09,1.98816e+07
20131022,508500,465600,42900,114061,1.75345e+10,7.14871e+09,2.08857e+07
20131023,508400,464100,44300,-89366,1.75156e+10,7.1165e+09,2.05533e+07
20131024,507900,466300,41600,42940,1.75238e+10,7.1333e+09,2.05655e+07
20131025,508300,456200,52100,117572,1.75493e+10,7.17019e+09,2.01142e+07
20131028,508400,452500,55900,-6681,1.75492e+10,7.15914e+09,2.00816e+07
20131029,508000,455500,52500,111247,1.75713e+10,7.19828e+09,2.04052e+07
20131030,508100,444600,63500,-136637,1.75428e+10,7.14755e+09,1.96533e+07
20131031,508300,443400,64900,-51781,1.75337e+10,7.13107e+09,1.92476e+07
20131101,508600,443000,65600,56456,1.7544e+10,7.15795e+09,1.90418e+07
20131104,508700,439600,69100,101518,1.75613e+10,7.19795e+09,1.86764e+07
20131105,509100,430600,78500,-67432,1.75486e+10,7.19374e+09,1.80309e+07
20131106,509300,427100,82200,76684,1.75653e+10,7.20578e+09,1.77133e+07
20131107,510100,412900,97200,-236603,1.75152e+10,7.11102e+09,1.6494e+07
20131108,510400,409000,101400,209593,1.7559e+10,7.21097e+09,1.63913e+07
20131111,510000,401800,108200,25198,1.75646e+10,7.21648e+09,1.53394e+07
20131112,510100,399200,110900,-26519,1.75585e+10,7.20131e+09,1.48259e+07
20131113,508300,402300,106000,122993,1.75814e+10,7.2429e+09,1.45676e+07
20131114,507100,414600,92500,97214,1.75992e+10,7.27502e+09,1.60024e+07
20131115,506500,419300,87200,64897,1.76125e+10,7.29029e+09,1.64108e+07
20131118,505600,433300,72300,-63694,1.7601e+10,7.23651e+09,1.78013e+07
20131119,505600,429600,76000,-75358,1.75851e+10,7.20537e+09,1.76166e+07
20131120,506000,430100,75900,-56684,1.75737e+10,7.18907e+09,1.77299e+07
20131121,505800,427600,78200,166643,1.7605e+10,7.25759e+09,1.77558e+07
20131122,505600,423600,82000,102886,1.76267e+10,7.29269e+09,1.74859e+07
20131125,505300,425200,80100,7233,1.76265e+10,7.27446e+09,1.74578e+07
20131126,504400,425800,78600,26231,1.7628e+10,7.26698e+09,1.75766e+07
20131127,502900,431200,71700,56299,1.76382e+10,7.26214e+09,1.77019e+07
20131129,503100,424800,78300,-38542,1.76304e+10,7.25321e+09,1.72631e+07
20131202,502600,421000,81600,-51288,1.76193e+10,7.222e+09,1.68549e+07
20131203,502600,419600,83000,-93087,1.76012e+10,7.19107e+09,1.65263e+07
20131204,502700,410200,92500,-40405,1.75941e+10,7.18197e+09,1.59891e+07
20131205,502700,408800,93900,-56625,1.75827e+10,7.16161e+09,1.58267e+07
20131206,502600,406600,96000,213016,1.76239e+10,7.23721e+09,1.56665e+07
20131209,502100,407600,94500,42496,1.76333e+10,7.24112e+09,1.57083e+07
20131210,501700,403500,98200,-16245,1.76312e+10,7.21328e+09,1.51755e+07
20131211,501900,396800,105100,-162765,1.75983e+10,7.13416e+09,1.42969e+07
20131212,502200,390900,111300,-24633,1.75917e+10,7.12949e+09,1.34358e+07
20131213,503200,361200,142000,42220,1.76028e+10,7.15527e+09,1.14454e+07
20131216,502000,340400,161600,88642,1.76192e+10,7.18312e+09,9.33841e+06
20131217,501000,314000,187000,-53873,1.76013e+10,7.13961e+09,6.74024e+06
20131218,500300,329000,171300,146256,1.76305e+10,7.24615e+09,8.02558e+06
20131219,500300,340900,159400,-16059,1.76296e+10,7.24697e+09,9.43317e+06
20131220,497900,380300,117600,100796,1.76477e+10,7.26742e+09,1.29216e+07
20131223,496500,408300,88200,42065,1.76662e+10,7.1885e+09,1.58484e+07
20131224,493000,432700,60300,57693,1.76762e+10,7.17937e+09,1.85569e+07
20131226,491700,441700,50000,67494,1.769e+10,7.18537e+09,1.93976e+07
20131227,489300,445900,43400,-2653,1.76901e+10,7.15033e+09,2.02329e+07
20131230,487800,447100,40700,39322,1.76957e+10,7.14168e+09,2.05901e+07
20131231,487400,456600,30800,73334,1.77098e+10,7.16236e+09,2.15713e+07
20140102,487400,462800,24600,-214810,1.76663e+10,7.09745e+09,2.1821e+07
20140103,487100,462900,24200,20790,1.76705e+10,7.09439e+09,2.19536e+07
20140106,487100,463000,24100,-73857,1.76539e+10,7.06618e+09,2.18927e+07
20140107,487400,462500,24900,151176,1.76849e+10,7.11301e+09,2.18809e+07
20140108,487300,458300,29000,20493,1.76891e+10,7.12051e+09,2.15457e+07
20140109,487200,454300,32900,50192,1.77016e+10,7.12767e+09,2.09864e+07
20140110,487000,454300,32700,114112,1.77257e+10,7.15957e+09,2.07146e+07
20140113,486700,444200,42500,-280115,1.76727e+10,7.04806e+09,1.95758e+07
20140114,487400,436100,51300,227918,1.77192e+10,7.14855e+09,1.89641e+07
20140115,487500,417500,70000,85433,1.77344e+10,7.16772e+09,1.75992e+07
20140116,487000,412600,74400,23653,1.77404e+10,7.15358e+09,1.67594e+07
20140117,488100,397400,90700,-13452,1.77356e+10,7.14796e+09,1.50105e+07
20140121,488100,394400,93700,82827,1.7752e+10,7.16188e+09,1.49678e+07
20140122,487400,391700,95700,-48602,1.77449e+10,6.95101e+09,1.47581e+07
20140123,488000,374800,113200,-140829,1.77119e+10,6.91062e+09,1.28347e+07
20140124,488200,344000,144200,-246629,1.76555e+10,6.74902e+09,9.94971e+06
20140127,490500,302300,188200,-6314,1.76523e+10,6.74874e+09,5.85344e+06
20140128,492500,269400,223100,12442,1.76553e+10,6.857e+09,2.13451e+06
20140129,494600,229300,265300,34709,1.7663e+10,6.82882e+09,-1.5341e+06
20140130,493200,192000,301200,24929,1.76691e+10,6.89949e+09,-4.52623e+06
20140131,493200,188700,304500,93988,1.76908e+10,6.8684e+09,-4.81468e+06
20140203,493800,160700,333100,221077,1.77386e+10,6.70001e+09,-6.42804e+06
20140204,494100,150400,343700,-63918,1.77263e+10,6.76187e+09,-7.221e+06
20140205,494400,144500,349900,-22467,1.77205e+10,6.75055e+09,-8.09464e+06
20140206,494000,134700,359300,-125511,1.76969e+10,6.8387e+09,-9.27768e+06
20140207,493700,138500,355200,-108426,1.76758e+10,6.93391e+09,-8.526e+06
20140210,493000,161700,331300,13205,1.76789e+10,6.93273e+09,-6.11814e+06
20140211,491900,221200,270700,-1083,1.7679e+10,6.98821e+09,-518901
20140212,490200,296200,194000,23777,1.76865e+10,6.96665e+09,6.97364e+06
20140213,488200,353100,135100,103488,1.77094e+10,6.9828e+09,1.24426e+07
20140214,486500,381800,104700,63855,1.77203e+10,6.97896e+09,1.55309e+07
20140218,485200,413000,72200,63116,1.77345e+10,6.98265e+09,1.85902e+07
20140219,483800,425300,58500,-99366,1.7715e+10,6.9206e+09,1.95278e+07
20140220,483500,439900,43600,154547,1.77461e+10,6.9683e+09,2.09179e+07
20140221,483200,447300,35900,8268,1.77486e+10,6.96758e+09,2.12392e+07
20140224,482500,453300,29200,138064,1.7774e+10,7.01282e+09,2.15808e+07
20140225,482000,451500,30500,-31946,1.77677e+10,7.00003e+09,2.16391e+07
20140226,482000,452500,29500,34471,1.77716e+10,7.00598e+09,2.17954e+07
20140227,481600,456800,24800,91161,1.7789e+10,7.0344e+09,2.22655e+07
20140228,481400,461400,20000,69600,1.78014e+10,7.05245e+09,2.27864e+07
20140303,482000,454000,28000,-171669,1.77647e+10,7.0264e+09,2.22655e+07
20140304,481400,453900,27500,347468,1.78326e+10,7.12644e+09,2.2481e+07
20140305,481000,455600,25400,-20160,1.78289e+10,7.11129e+09,2.267e+07
20140306,480600,456400,24200,37600,1.78352e+10,7.11745e+09,2.2757e+07
20140307,480300,456400,23900,24479,1.784e+10,7.11503e+09,2.26414e+07
20140310,480200,455200,25000,-89068,1.78194e+10,7.08768e+09,2.256e+07
20140311,480600,446600,34000,-112548,1.7798e+10,7.05903e+09,2.17249e+07
20140312,481100,440100,41000,2938,1.77985e+10,7.07249e+09,2.1141e+07
20140313,481600,420500,61100,-219298,1.77557e+10,6.98465e+09,1.92317e+07
20140314,481900,404600,77300,343,1.77551e+10,6.98886e+09,1.74854e+07
20140317,482100,389200,92900,159341,1.77859e+10,7.0502e+09,1.65912e+07
20140318,482400,381600,100800,94193,1.78047e+10,7.10793e+09,1.57276e+07
20140319,482100,368500,113600,-78048,1.77903e+10,7.05194e+09,1.4189e+07
20140320,481600,373300,108300,89543,1.78095e+10,7.06963e+09,1.43799e+07
20140321,480800,378300,102500,9839,1.78098e+10,7.02883e+09,1.49781e+07
20140324,480100,375400,104700,-79970,1.77921e+10,6.95244e+09,1.4721e+07
20140325,479900,361300,118600,30820,1.77987e+10,6.96528e+09,1.24603e+07
20140326,479600,347000,132600,-35275,1.77924e+10,6.90593e+09,1.02982e+07
20140327,479600,339500,140100,-30399,1.77868e+10,6.89289e+09,8.48401e+06
20140328,479200,327100,152100,69849,1.78015e+10,6.91979e+09,6.41335e+06
20140331,478300,321900,156400,52192,1.78108e+10,6.9693e+09,6.19576e+06
20140401,477800,329800,148000,-44624,1.7798e+10,7.01605e+09,7.06811e+06
20140402,477000,346300,130700,33860,1.78075e+10,7.02844e+09,9.36506e+06
20140403,475900,390000,85900,136346,1.78462e+10,6.99064e+09,1.32083e+07
20140404,475400,405000,70400,-95670,1.78303e+10,6.87292e+09,1.46744e+07
20140407,475400,406400,69000,-181766,1.77957e+10,6.78111e+09,1.46101e+07
20140408,475700,398200,77500,64466,1.78063e+10,6.82507e+09,1.43414e+07
20140409,475700,394000,81700,37920,1.78097e+10,6.89798e+09,1.38079e+07
20140410,476600,342400,134200,-78224,1.77993e+10,6.75977e+09,9.19116e+06
20140411,478700,283700,195000,32327,1.78073e+10,6.71297e+09,4.08741e+06
20140414,478600,263600,215000,19581,1.781e+10,6.7604e+09,2.10263e+06
20140415,478900,243400,235500,24710,1.78094e+10,6.77932e+09,521047
20140416,478800,229200,249600,-30256,1.78025e+10,6.85611e+09,-804373
20140417,478700,235900,242800,-10011,1.7803e+10,6.86706e+09,-33442
20140421,478100,263600,214500,2952,1.78033e+10,6.87606e+09,3.46195e+06
20140422,477000,310500,166500,-1358,1.78053e+10,6.90059e+09,8.40949e+06
20140423,474600,335000,139600,30598,1.78112e+10,6.84363e+09,1.13973e+07
20140424,474400,346200,128200,19110,1.78152e+10,6.8348e+09,1.27988e+07
20140425,474300,355900,118400,-80559,1.77958e+10,6.75907e+09,1.35491e+07
20140428,474400,356500,117900,55123,1.78074e+10,6.75459e+09,1.36116e+07
20140429,474200,347500,126700,20567,1.78105e+10,6.78718e+09,1.25243e+07
20140430,474000,356400,117600,73910,1.7825e+10,6.81092e+09,1.34481e+07
20140501,474600,355200,119400,2124,1.78255e+10,6.8299e+09,1.33661e+07
20140502,474100,361300,112800,-44805,1.78169e+10,6.82602e+09,1.37679e+07
20140505,472600,373600,99000,32635,1.78234e+10,6.81873e+09,1.52698e+07
20140506,472300,376000,96300,-103826,1.7804e+10,6.75073e+09,1.55027e+07
20140507,472300,379800,92500,162351,1.78394e+10,6.79107e+09,1.56499e+07
20140508,472200,383100,89100,-34546,1.78317e+10,6.77202e+09,1.57415e+07
20140509,472500,377100,95400,5375,1.78347e+10,6.7856e+09,1.50661e+07
20140512,472400,374900,97500,119037,1.78588e+10,6.86784e+09,1.45801e+07
20140513,472100,383300,88800,-7568,1.78583e+10,6.85374e+09,1.50433e+07
20140514,472400,379600,92800,-92197,1.78415e+10,6.82424e+09,1.52438e+07
20140515,476200,370200,106000,-157479,1.78099e+10,6.80256e+09,1.42993e+07
20140516,476300,365400,110900,78084,1.78262e+10,6.84279e+09,1.40668e+07
20140519,476100,363000,113100,82140,1.78419e+10,6.86628e+09,1.45063e+07
20140520,476700,341900,134800,-114819,1.78192e+10,6.81572e+09,1.29554e+07
20140521,477000,333600,143400,105381,1.78408e+10,6.87745e+09,1.28367e+07
20140522,477000,339000,138000,33527,1.78464e+10,6.89878e+09,1.34837e+07
20140523,476600,352500,124100,98982,1.78673e+10,6.93146e+09,1.4726e+07
20140527,476600,363500,113100,102138,1.78859e+10,6.97481e+09,1.54106e+07
20140528,476900,387100,89800,-16983,1.7883e+10,6.96191e+09,1.73249e+07
20140529,475500,405800,69700,93432,1.79018e+10,6.9851e+09,1.87157e+07
20140530,474100,423400,50700,35103,1.79086e+10,6.98538e+09,2.01415e+07
20140602,473900,439500,34400,28531,1.79131e+10,6.9964e+09,2.12367e+07
20140603,473300,439700,33600,-802,1.79163e+10,6.97662e+09,2.13356e+07
20140604,472200,441800,30400,66525,1.79303e+10,6.97864e+09,2.17165e+07
20140605,470900,446800,24100,150414,1.7961e+10,7.00209e+09,2.23039e+07
20140606,469900,445900,24000,124178,1.79873e+10,7.02366e+09,2.22588e+07
20140609,469100,442600,26500,-67701,1.7969e+10,6.95043e+09,2.21605e+07
20140610,469000,448400,20600,-30170,1.79645e+10,6.93507e+09,2.23606e+07
20140611,468500,450000,18500,-100423,1.79456e+10,6.89968e+09,2.24866e+07
20140612,468600,449000,19600,-149582,1.79136e+10,6.85801e+09,2.22583e+07
20140613,468500,450900,17600,78012,1.793e+10,6.87886e+09,2.21849e+07
20140616,468000,445000,23000,30497,1.79349e+10,6.87529e+09,2.17198e+07
20140617,468100,439700,28400,72260,1.79457e+10,6.89528e+09,2.12019e+07
20140618,468100,437700,30400,157777,1.79792e+10,6.94455e+09,2.0748e+07
20140619,468000,442500,25500,30385,1.79856e+10,6.94704e+09,2.11597e+07
20140620,467600,438700,28900,59328,1.79979e+10,6.95367e+09,2.08482e+07
20140623,467500,431500,36000,-13416,1.79962e+10,6.94808e+09,2.04729e+07
20140624,467400,429600,37800,-163397,1.79676e+10,6.90917e+09,2.02962e+07
20140625,467100,423100,44000,87696,1.79879e+10,6.93565e+09,2.04184e+07
20140626,466700,422100,44600,-46684,1.79733e+10,6.919e+09,2.01206e+07
20140627,466400,415500,50900,48384,1.79814e+10,6.929e+09,1.93315e+07
20140630,465900,412400,53500,29005,1.79865e+10,6.92015e+09,1.88764e+07
20140701,465200,414500,50700,106627,1.80086e+10,6.96314e+09,1.87271e+07
20140702,464700,417500,47200,-60668,1.80016e+10,6.94102e+09,1.89029e+07
20140703,464300,416600,47700,98379,1.80208e+10,6.97632e+09,1.90987e+07
20140707,464200,417800,46400,-100334,1.80008e+10,6.93663e+09,1.93818e+07
20140708,464000,418100,45900,-113914,1.79772e+10,6.88558e+09,1.93757e+07
20140709,463900,414400,49500,90136,1.79958e+10,6.91224e+09,1.90697e+07
20140710,463900,420200,43700,-88075,1.79791e+10,6.87179e+09,1.92318e+07
20140711,464100,408100,56000,19438,1.79825e+10,6.88107e+09,1.79233e+07
20140714,464000,398400,65600,57245,1.79963e+10,6.90712e+09,1.7102e+07
20140715,463800,391600,72200,-30208,1.79873e+10,6.88276e+09,1.62205e+07
20140716,463300,389100,74200,63002,1.79991e+10,6.89314e+09,1.61798e+07
20140717,463100,376700,86400,-149572,1.79683e+10,6.81612e+09,1.47087e+07
20140718,462900,372900,90000,149793,1.8001e+10,6.8798e+09,1.49633e+07
20140721,463600,350200,113400,-9530,1.79972e+10,6.87378e+09,1.32606e+07
20140722,462900,343800,119100,89641,1.80168e+10,6.89478e+09,1.28337e+07
20140723,462800,338900,123900,15014,1.80181e+10,6.90779e+09,1.24761e+07
20140724,461500,340300,121200,41999,1.80251e+10,6.9025e+09,1.31301e+07
20140725,461400,332900,128500,-48000,1.8012e+10,6.87096e+09,1.25817e+07
20140728,461300,331500,129800,30219,1.80192e+10,6.86665e+09,1.2237e+07
20140729,461300,321800,139500,-64160,1.80075e+10,6.83015e+09,1.06854e+07
20140730,462000,321200,140800,26477,1.80134e+10,6.84325e+09,1.04545e+07
20140731,463000,293000,170000,-111131,1.7988e+10,6.71972e+09,6.94954e+06
20140801,463400,260000,203400,-44927,1.79808e+10,6.71254e+09,3.45311e+06
20140804,464200,233900,230300,41508,1.79868e+10,6.76626e+09,752353
20140805,465300,190200,275100,35048,1.79947e+10,6.72492e+09,-2.93425e+06
20140806,466300,165100,301200,10811,1.7999e+10,6.74181e+09,-5.32758e+06
20140807,466400,159700,306700,-6261,1.79961e+10,6.70726e+09,-6.39413e+06
20140808,466200,157500,308700,-95276,1.79739e+10,6.79627e+09,-5.95046e+06
20140811,466000,155400,310600,-8632,1.79725e+10,6.81065e+09,-5.82045e+06
20140812,465700,170000,295700,-2093,1.79721e+10,6.79176e+09,-4.47837e+06
20140813,465300,198800,266500,-43172,1.79616e+10,6.82699e+09,-2.00207e+06
20140814,464600,251500,213100,49750,1.79713e+10,6.85517e+09,4.2772e+06
20140815,464200,281400,182800,6305,1.79735e+10,6.852e+09,6.8379e+06
20140818,463600,321700,141900,107452,1.79959e+10,6.9033e+09,1.08699e+07
20140819,462900,369500,93400,83730,1.80105e+10,6.93211e+09,1.60233e+07
20140820,461700,399700,62000,60405,1.8021e+10,6.94059e+09,1.88773e+07
20140821,460500,421400,39100,48472,1.80311e+10,6.93225e+09,2.05983e+07
20140822,459000,434000,25000,-38686,1.80203e+10,6.89433e+09,2.14666e+07
20140825,457400,440100,17300,99819,1.80413e+10,6.89613e+09,2.20693e+07
20140826,456600,444900,11700,3953,1.80406e+10,6.8883e+09,2.27238e+07
20140827,456500,452900,3600,-5638,1.8038e+10,6.87834e+09,2.35608e+07
20140828,456200,453900,2300,-22879,1.80341e+10,6.86574e+09,2.37618e+07
20140829,456200,453900,2300,88543,1.80531e+10,6.88528e+09,2.38503e+07
20140902,456500,453100,3400,-684,1.8052e+10,6.88661e+09,2.37414e+07
20140903,456300,452200,4100,-1223,1.80518e+10,6.88311e+09,2.36115e+07
20140904,456400,451700,4700,-18335,1.80486e+10,6.87324e+09,2.35976e+07
20140905,456400,450200,6200,109204,1.80702e+10,6.90622e+09,2.34794e+07
20140908,456700,444800,11900,-76338,1.80541e+10,6.89014e+09,2.29234e+07
20140909,457200,435100,22100,-153886,1.80247e+10,6.85283e+09,2.1348e+07
20140910,457500,426000,31500,38130,1.80305e+10,6.87476e+09,2.04216e+07
20140911,457800,416500,41300,29014,1.80366e+10,6.88402e+09,1.95316e+07
20140912,458600,394000,64600,-94534,1.80164e+10,6.84655e+09,1.73139e+07
20140915,459400,377800,81600,-20640,1.80145e+10,6.84005e+09,1.51664e+07
20140916,459100,362400,96700,89469,1.80318e+10,6.88283e+09,1.35699e+07
20140917,459100,353000,106100,49371,1.80425e+10,6.89571e+09,1.26699e+07
20140918,458800,343400,115400,86045,1.806e+10,6.92558e+09,1.21066e+07
20140919,458600,342500,116100,-8589,1.80569e+10,6.91445e+09,1.19737e+07
20140922,458800,337900,120900,-65684,1.80437e+10,6.8482e+09,1.16584e+07
20140923,459200,319000,140200,-94571,1.80258e+10,6.81115e+09,9.91461e+06
20140924,459300,309500,149800,107670,1.80471e+10,6.87267e+09,9.20871e+06
20140925,460500,288600,171900,-109282,1.80248e+10,6.788e+09,6.75717e+06
20140926,461100,267600,193500,26576,1.80308e+10,6.85639e+09,5.13842e+06
20140929,460900,242600,218300,33047,1.80384e+10,6.84847e+09,3.56748e+06
20140930,461100,236400,224700,48857,1.80481e+10,6.82891e+09,3.01668e+06
20141001,462700,198300,264400,7508,1.80475e+10,6.74932e+09,-221213
20141002,463000,189300,273700,14799,1.80514e+10,6.76722e+09,-1.25576e+06
20141003,463000,183900,279100,37983,1.80599e+10,6.8379e+09,-1.36777e+06
20141006,462900,177900,285000,10396,1.80643e+10,6.82329e+09,-1.9755e+06
20141007,462900,169800,293100,129394,1.80912e+10,6.71583e+09,-3.193e+06
20141008,462300,179300,283000,-7297,1.80927e+10,6.82419e+09,-1.87972e+06
20141009,462400,176400,286000,186492,1.81257e+10,6.68284e+09,-2.32224e+06
20141010,462800,157100,305700,222413,1.81756e+10,6.61543e+09,-4.27193e+06
20141013,464200,126600,337600,225579,1.82191e+10,6.51774e+09,-7.6378e+06
20141014,464200,113400,350800,-23334,1.82155e+10,6.55083e+09,-8.98456e+06
20141015,464600,102800,361800,-12679,1.82089e+10,6.5311e+09,-1.03103e+07
20141016,465000,93700,371300,-110813,1.81894e+10,6.54315e+09,-1.18924e+07
20141017,464900,97000,367900,-175588,1.81583e+10,6.6268e+09,-1.18991e+07
20141020,464300,111600,352700,-71198,1.81439e+10,6.68195e+09,-1.04974e+07
20141021,463900,140300,323600,-227107,1.80996e+10,6.81807e+09,-7.41145e+06
20141022,463900,201700,262200,75936,1.81143e+10,6.76122e+09,-215914
20141023,462300,262800,199500,82420,1.81301e+10,6.82832e+09,6.9095e+06
20141024,460000,324600,135400,118294,1.81557e+10,6.8357e+09,1.27104e+07
20141027,459600,379700,79900,23716,1.81606e+10,6.82606e+09,1.69823e+07
20141028,459100,393500,65600,216194,1.81995e+10,6.91003e+09,1.83346e+07
20141029,458900,424400,34500,-55663,1.8191e+10,6.88133e+09,2.01449e+07
20141030,459100,435400,23700,179948,1.82285e+10,6.94648e+09,2.1506e+07
20141031,458900,446000,12900,286188,1.82843e+10,7.02998e+09,2.27886e+07
20141103,459300,448900,10400,-11043,1.82773e+10,7.03808e+09,2.31565e+07
20141104,458900,446900,12000,-64572,1.8265e+10,7.00544e+09,2.28297e+07
20141105,459000,447900,11100,168207,1.83004e+10,7.04055e+09,2.31153e+07
20141106,459500,447300,12200,107859,1.83223e+10,7.08655e+09,2.3145e+07
20141107,459500,446400,13100,9183,1.83218e+10,7.09082e+09,2.30289e+07
20141110,459800,442600,17200,93168,1.83408e+10,7.11864e+09,2.26969e+07
20141111,459800,443600,16200,10992,1.83419e+10,7.12502e+09,2.28449e+07
20141112,460200,444600,15600,-28957,1.83344e+10,7.1293e+09,2.29258e+07
20141113,460500,441900,18600,-22324,1.83295e+10,7.12565e+09,2.26439e+07
20141114,460900,440100,20800,-24059,1.83273e+10,7.12571e+09,2.23876e+07
20141117,461100,439500,21600,40540,1.8334e+10,7.135e+09,2.23255e+07
20141118,461400,437100,24300,113219,1.83575e+10,7.18255e+09,2.19752e+07
20141119,461400,431600,29800,-22697,1.83529e+10,7.17767e+09,2.18197e+07
20141120,461300,434900,26400,52903,1.83639e+10,7.19221e+09,2.20558e+07
20141121,461300,435500,25800,130180,1.83909e+10,7.23022e+09,2.19344e+07
20141124,461200,437100,24100,81320,1.84077e+10